#######################################
##  #######################   ####      
##        ###     #####  #    ####      
####             #########    ####     #
####            ##########    ####      
###           ############    ####      
## #### ####  ############     ##       
####### #### #############     ###      
######## ### #############    ####   #  
######## ### #############    ####      
##########################    ####   #  
##########################    ####      
##########################    ####      
##########################    ####      
##########################    ####      
##########################    ####      
#########################     ####      
##########################    ####      
#########################     ####      
#########################      ###      
##########################     ###    ##
#########################             ##
##########################            ##
##########################      #     ##
##########################     ###    ##
##########################    ####    ##
##########################   #####  ####
##########################  ####### ####
########################## #############
########################################
########################################
########################################
########################################
########################################
########################################
########################################
########################################
########################################
########################################
########################################
#