:::::::::::::::::::::::::::::::::::::::::::::::::::::::::::::::::##:::::::::::::
::::::::::::::::::::::::::::::::::::::::::::::::::::::::::::::::##            ::
::::::::::::::::::::::::::::::::::::::::::::::::::::::::::::::::#:             #
::::::::::::::::::::::::::::::::::::::::::::::::::::::::::::::::#:             #
::::::::::::::::::::::::::::::::::::::::::::::::::::::::::::::::#              #
::::::::::::::::::::::::::::::::::::::::::::::::::::::::::::::::#              #
::::::::::::::::::::::::::::::::::::::::::::::::::::::::::::::::#              #
::::::::::::::::::::::::::::::::::::::::::::::::::::::::::::::::#              #
::::::::::::::::::::::::::::::::::::::::::::::::::::::::::::::::#              #
::::::::::::::::::::::::::::::::::::::::::::::::::::::::::::::::#              #
::::::::::::::::::::::::::::::::::::::::::::::::::::::::::::::::#              #
::::::::::::::::::::::::::::::::::::::::::::::::::::::::::::::::#              #
::::::::::::::::::::::::::::::::::::::::::::::::::::::::::::::::#              #
::::::::::::::::::::::::::::::::::::::::::::::::::::::::::::::::#              #
::::::::::::::::::::::::::::::::::::::::::::::::::::::::::::::::#              #
::::::::::::::::::::::::::::::::::::::::::::::::::::::::::::::::#              #
::::::::::::::::::::::::::::::::::::::::::::::::::::::::::::::::#              #
::::::::::::::::::::::::::::::::::::::::::::::::::::::::::::::::#              #
::::::::::::::::::::::::::::::::::::::::::::::::::::::::::::::::#              #
::::::::::::::::::::::::::::::::::::::::::::::::::::::::::::::::#              #
::::::::::::::::::::::::::::::::::::::::::::::::::::::::::::::::#              #
:::::::::::::::::::::::::::::::::::::::::::::::::::::::::::::::::              #
::::::::::::::::::::::::::::::::::::::::::::::::::::::::::::::::#              #
::::::::::::::::::::::::::::::::::::::::::::::::::::::::::::::::#              #
::::::::::::::::::::::::::::::::::::::::::::::::::::::::::::::::#              #
::::::::::::::::::::::::::::::::::::::::::::::::::::::::::::::::#              #
::::::::::::::::::::::::::::::::::::::::::::::::::::::::::::::::#              #
::::::::::::::::::::::::::::::::::::::::::::::::::::::::::::::::#              #
::::::::::::::::::::::::::::::::::::::::::::::::::::::::::::::::               #
::::::::::::::::::::::::::::::::::::::::::::::::::::::::::::::::#              #
::::::::::::::::::::::::::::::::::::::::::::::::::::::::::::::::#              #
:::::::::::::::::::::::::::::::::::::::::::::::::::::::    :::::#              #
:::::::::::::::::::::::::::::::::::::::::::::::::::::      :::::#              #
::::::::::::::::::::::::::::::::::::::::::::::::::::        ::::#              #
::::::::::::::::::::::::::::::::::::::::::::::::::          ::::#              #
::::::::::::::::::::::::::::::::::::::::::::::::::           :::               #
:::::::::::::::::::::::::::::::::::::::::::::::::                              #
::::::::::::::::::::::::::::::::::::::::::::::::                               #
::::::::::::::::::::::::::::::::::::::::::::::::                               #
::::::::::::::::::::::::::::::::::::::::::::::::#                              #
::::::::::::::::::::::::::::::::::::::::::::::::#                           ####
::::::::::::::::::::::::::::::::::::::::::::::::#                           ::::
::::::::::::::::::::::::::::::::::::::::::::::::#                           #:::
::::::::::::::::::::::::::::::::::::::::::::::::#                           #:::
::::::::::::::::::::::::::::::::::::::::::::::::#                           #:::
::::::::::::::::::::::::::::::::::::::::::::::::#                           #:::
::::::::::::::::::::::::::::::::::::::::::::::::#                           #:::
::::::::::::::::::::::::::::::::::::::::::::::::#                            :::
::::::::::::::::::::::::::::::::::::::::::::::::#                            :::
::::::::::::::::::::::::::::::::::::::::::::::::#                            #::
::::::::::::::::::::::::::::::::::::::::::::::::#                          :::::
::::::::::::::::::::::::::::::::::::::::       :                           #::::
::::::::::::::::::::::::::::::::::::::::::::::::#                          #::::
::::::::::::::::::::::::::::::::::::::::::::::::#                      #####::::
::::::::::::::::::::::::::::::::::::::::::::::::#                     #:::::::::
::::::::::::::::::::::::::::::::::::::::::::::::#                     #:::::::::
::::::::::::::::::::::::::::::::::::::::::::::::#                     #:::::::::
::::::::::::::::::::::::::::::::::::::::::::::::#                     #:::::::::
::::::::::::::::::::::::::::::::::::::::::::::::#                     #:::::::::
:::::::::::::::::::::::::::::::::::::::::::::::#                      #:::::::::
:::::::::::::::::::::::::::::::::::::::::::::::#                      #:::::::::
:::::::::::::::::::::::::::::::::::::::::::::::#                      #:::::::::
:::::::::::::::::::::::::::::::::::::::::::::::#                      ::::::::::
:::::::::::::::::::::::::::::::::::                                 ::::::::::::
:::::::::::::::::::::::::::::::::::                                 ::::::::::::
:::::::::::::::::::::::::::::::::::                                :::::::::::::
:::::::::::::::::::::::::::::::::::::::::::::::#                ###:::::::::::::
:::::::::::::::::::::::::::::::::::::::::::::::#                #:::::::::::::::
:::::::::::::::::::::::::::::::::::::::::::::::#                #:::::::::::::::
:::::::::::::::::::::::::::::::::::::::::::::::#                #:::::::::::::::
:::::::::::::::::::::::::::::::::::::::::::::::#                #:::::::::::::::
:::::::::::::::::::::::::::::::::::::::::::::::#                #:::::::::::::::
:::::::::::::::::::::::::::::::::::::::::::::::#                #:::::::::::::::
:::::::::::::::::::::::::::::::::::::::::::::::#                 :::::::::::::::
:::::::::::::::::::::::::::::::::::::::::::::::#                 #::::::::::::::
:::::::::::::::::::::::::::::::::::::::::::::::#                :#::::::::::::::
:::::::::::::::::::::::::::::::::::::::::::::::#                :#::::::::::::::
:::::::::::::::::::::::::::::::::::::::::::::::#                #:::::::::::::::
:::::::::::::::::::::::::::::::::::::::::::::::#                #:::::::::::::::
:::::::::::::::::::::::::::::::::::::::::::::::##################:::::::::::::::
