::                                                                  ::  ::  ::    ::::  ::::::::::::::::::::::::::::::::::::::::::::::::::::::::::::::::::::::  
  ######################################################################################################      ####::::::::::::::::                            ##
  ##                                                                                              ::                                                          ##
  ##      xxxxxxxx  xxxxxxxxxxxxxx  xxxxxx                                                                                                                    ##
  ##    xx                                xxxxxxxxxxxxxxxx  xxxxxxxxxxxxxxxxxx  xxxxxxxxxxxxxxxxxxxx  xx                                                      ##
  ##    xx                                                                                              xxxxxxxxxxxxxxxxxxxxxxxxxxxxxxxxxxxxxxxxxx            ##
  ##    xx                                                                                                                                                    ##
  ##    xx                                                                                                                                                    ##
  ##    xx                                                                                                                                                    ##
  ##    xx                                                                                                                                                    ##
  ##    xx    ##############                                                                        ######                      ####                          ##
  ##    xx      ##                                                            ######################################################                          ##
  ##    xx      ##  ::::::            ############################            ####::::::::::::::::::::::::::::::::::::::::::::::::                            ##
  ##  xx        ##  ::::::            ############################            ####::::::::::::::::::::::::::::::::::::::::::::::::                            ##
  ##  xx        ##  ::::::            ##  ::::::::::::::::::::::              ####::::::::::::::::::::::::::::::::::::::::::::::::                            ##
  ##  xx        ##  ::::::            ##  ::::::::::::::::::::::::            ####::::::::::::::::::::::::::::::::::::::::::::::::                            ##
  ##            ##  ::::::            ##::::::::::::::::::::::::::            ##  ::::::::::::::::::::::::::::::::::::::::::::::::                            ##
  ##  xx        ##  ::::::            ##::::::::::::::::::::::::::            ##  ::::::::::::::::::::::::::::::::::::::::::::::::##                          ##
  ##  xx        ##  ::::::                ::::::::::::::::::::::::            ##  ::::::::::::::::::::::::::::::::::::::::::::::::                            ##
  ##  xx        ##  ::::::  ::            ::::::::::::::::::::::::            ##  ::::::::::::::::::::::::::::::::::::::::::::::::                            ##
  ##  xx        ##  ::::::  ::              ::::::::::::::::::::::            ##  ::::::::::::::::::::::::::::::::::::::::::::::::                            ##
  ##  xx        ##  ::::    ::                ::::::::::::::::::::            ##  ::::::::::::::::::::::::::::::::::::::::::::::::                            ##
  ##  xx        ##  ::::    ::                  ::::::::::::::::::            ##::::::::::::::::::::::::::::::::::::::::::::::::::                            ##
  ##  xx        ##  ::::##  ::                    ::::::::::::::::            ##::::::::::::::::::::::::::::::::::::::::::::::::::                            ##
  ##  xx        ##  ::::::  ::::    ############  ::::::::::::::::            ##::::::::::::::::::::::::::::::::::::::::::::::::::                            ##
  ##  xx        ##  ::::::  ::::    ##        ######::::::::::::::            ##::::::::::::::::::::::::::::::::::::::::::::::::::                            ##
  ##  xx        ##  ::::::  ::::    ##::::::::::::::::::::::::::::            ##::::::::::::::::::::::::::::::::::::::::::::::::::      ########################
  ##  xx        ##::::::    ::::    ##::::::::::::::::::::::::::::            ##::::::::::::::::::::::::::::::::::::::::::::::::::##########                  ##
  ##  xx        ##::::::  ::::::    ##::::::::::::::::::::::::::::            ##::::::::::::::::::::::::::::::::::::::::::::::::::::::::::::::::::::::::::::::::
  ##  xx        ##::::::  ::::::::  ##::::::::::::::::::::::::::::            ##::::::::::::::::::::::::::::::::::::::::::::::::::::::::::::::::::::::::::::::::
  ##  xx        ##::::::  ::::::::  ##::::::::::::::::::::::::::::            ##::::::::::::::::::::::::::::::::::::::::::::::::::::::::::::::::::::::::::::::::
  ##  xx        ##::::::  ::::::::  ##::::::::::::::::::::::::::::            ##::::::::::::::::::::::::::::::::::::::::::::::::::::::::::::::::::::::::::::::::
  ##  xx        ##::::::  ::::::::  ##::::::::::::::::::::::::::::            ##::::::::::::::::::::::::::::::::::::::::::::::::::::::::::::::::::::::::::::::::
  ##            ##::::::  ::::::::  ##::::::::::::::::::::::::::::            ##::::::::::::::::::::::::::::::::::::::::::::::::::::::::::::::::::::::::::::::::
  ##  xx        ##::::::##::::::::  ##::::::::::::::::::::::::::::::          ##::::::::::::::::::::::::::::::::::::::::::::::::::::::::::::::::::::::::::::::::
  ##  xx        ##::::::::::::::::::##::::::::::::::::::::::::::::::              ::::::::::::::::::::::::::::::::::::::::::::::::::::::::::::::::::::::::::::::
  ##  xx        ##  ::::::::::::::  ####::::::::::::::::::::::::::::              ::::::::::::::::::::::::::::::::::::::::::::::::::::::::::::::::::::::::::::::
  ##  xx        ############        ####::::::::::::::::::::::::::::              ::::::::::::::::::::::::::::::::::::::::::::::::::::::::::::::::::::::::::::::
  ##  xx                            ####::::::::::::::::::::::::::::              ::::::::::::::::::::::::::::::::::::::::::::::::::::::::::::::::::::::::::::::
  ##  xx                  ::::::::::  ::::::::::::::::::::::::::::::              ::::::::::::::::::::::::::::::::::::::::::::::::::::::::::::::::::::::::::::::
  ##  xxxx    ::::::::::::::::::::::::  ::::::::::::::::::::::::::::              ::::::::::::::::::::::::::::::::::::::::::::::::::::::::::::::::::::::::::::::
::##      ::::::::::::::::::::::::::::  ::::::::::::::::::::::::::::              ::::::::::::::::::::::::::::::::::::::::::::::::::::::::::::::::::::::::::::::
::##      ::::::::::::::::::::::::::::  ::::::::::::::::::::::::::::                ::::::::::::::::::::::::::::::::::::::::::::::::::::::::::::::::::::::::::::
::##      ::::::::::::::::::::::::::::  ::::::::::::::::::::::::::::                ::::::::::::::::::::::::::::::::::::::::::::::::::::::::::::::::::::::::::::
::##    ::::::::::::::::::::::::::::::    ::::::::::::::::::::::::::                ::::::::::::::::::::::::::::::::::::::::::::::::::::::::::::::::::::::::::::
::##    ::::::::::::::::::::::::::::::::  ::::::::::::::::::::::::::                ::::::::::::::::::::::::::::::::::::::::::::::::::::::::::::::::::::::::::::
::##    ::::::::::::::::::::::::::::::::  ::::::::::::::::::::::::::                  ::::::::::::::::::::::::::::::::::::::::::::::::::::::::::::::::::::::::::
::##    ::::::::::::::::::::::::::::::::  ::::::::::::::::::::::::::                  ::::::::::::::::::::::::::::::::::::::::::::::::::::::::::::::::::::::::::
::##    ::::::::::::::::::::::::::::::::  ::::::::::::::::::::::::::                  ::::::::::::::::::::::::::::::::::::::::::::::::::::::::::::::::::::::::::
::##    ::::::::::::::::::::::::::::::::    ::::::::::::::::::::::::                    ::::::::::::::::::::::::::::::::::::::::::::::::::::::::::::::::::::::::
::##    ::::::::::::::::::::::::::::::::::##::::::::::::::::::::::::####################::::::::::::::::::::::::::::::::::::::::::::::::::::::::::::::::::::::::
::##    ::::::::::::::::::::::::::::::::::::::::::::::::::::::::::::                    ::::::::::::::::::::::::::::::::::::::::::::::::::::::::::::::::::::::::
::##    ::::::::::::::::::::::::::::::::::::::::::::::::::::::::::::  ::::::::::::::::::::::::::::::::::::::::::::::::::::::::::::::::::::::::::::::::::::::::::
::##  ::::::::::::::::::::::::::::::::::::::::::::::::::::::::::::::##::::::::::::::::::::::::::::::::::::::::::::::::::::::::::::::::::::::::::::::::::::::::::
::##  ::::::::::::::::::::::::::::::::::::::::::::::::::::::::::::::::::::::::::::::::::::::::::::::::::::::::::::::::::::::::::::::::::::::::::::::::::::::::::
::##  ::::::::::::::::::::::::::::::::::::::::::::::::::::::::::::::::::::::::::::::::::::::::::::::::::::::::::::::::::::::::::::::::::::::::::::::::::::::::::
::##  ::::::::::::::::::::::::::::::::::::::::::::::::::::::::::::::::::::::::::::::::::::::::::::::::::::::::::::::::::::::::::::::::::::::::::::::::::::::::::
::##  ::::::::::::::::::::::::::::::::::::::::::::::::::::::::::::::::::::::::::::::::::::::::::::::::::::::::::::::::::::::::::::::::::::::::::::::::::::::::::
::##  ::::::::::::::::::::::::::::::::::::::::::::::::::::::::::::::::::::::::::::::::::::::::::::::::::::::::::::::::::::::::::::::::::::::::::::::::::::::::::
::##  ::::::::::::::::::::::::::::::::::::::::::::::::::::::::::::::::::::::::::::::::::::::::::::::::::::::::::::::::::::::::::::::::::::::::::::::::::::::::::
::##  ::::::::::::::::::::::::::::::::::::::::::::::::::::::::::::::::::::::::::::::::::::::::::::::::::::::::::::::::::::::::::::::::::::::::::::::::::::::::::
::##::::::::::::::::::::::::::::::::::::::::::::::::::::::::::::::::::::::::::::::::::::::::::::::::::::::::::::::::::::::::::::::::::::::::::::::::::::::::::::
::##::::::::::::::::::::::::::::::::::::::::::::::::::::::::::::::::::::::::::::::::::::::::::::::::::::::::::::::::::::::::::::::::::::::::::::::::::::::::::::
::##::::::::::::::::::::::::::::::::::::::::::::::::::::::::::::::::::::::::::::::::::::::::::::::::::::::::::::::::::::::::::::::::::::::::::::::::::::::::::::
::##::::::::::::::::::::::::::::::::::::::::::::::::::::::::::::::::::::::::::::::::::::::::::::::::::::::::::::::::::::::::::::::::::::::::::::::::::::::::::::
::  ::::::::::::::::::::::::::::::::::::::::::::::::::::::::::::::::::::::::::::::::::::::::::::::::::::::::::::::::::::::::::::::::::::::::::::::::::::::::::::
::##::::::::::::::::::::::::::::::::::::::::::::::::::::::::::::::::::::::::::::::::::::::::::::::::::::::::::::::::::::::::::::::::::::::::::::::::::::::::::::
::::::::::::::::::::::::::::::::::::::::::::::::::::::::::::::::::::::::::::::::::::::::::::::::::::::::::::::::::::::::::::::::::::::::::::::::::::::::::::::::
::::::::::::::::::::::::::::::::::::::::::::::::::::::::::::::::::::::::::::::::::::::::::::::::::::::::::::::::::::::::::::::::::::::::::::::::::::::::::::::::
::::::::::::::::::::::::::::::::::::::::::::::::::::::::::::::::::::::::::::::::::::::::::::::::::::::::::::::::::::::::::::::::::::::::::::::::::::::::::::::::
::::::::::::::::::::::::::::::::::::::::::::::::::::::::::::::::::::::::::::::::::::::::::::::::::::::::::::::::::::::::::::::::::::::::::::::::::::::::::::::::
::::::::::::::::::::::::::::::::::::::::::::::::::::::::::::::::::::::::::::::::::::::::::::::::::::::::::::::::::::::::::::::::::::::::::::::::::::::::::::::::
::::::::::::::::::::::::::::::::::::::::::::::::::::::::::::::::::::::::::::::::::::::::::::::::::::::::::::::::::::::::::::::::::::::::::::::::::::::::::::::::
::::::::::::::::::::::::::::::::::::::::::::::::::::::::::::::::::::::::::::::::::::::::::::::::::::::::::::::::::::::::::::::::::::::::::::::::::::::::::::::::
::::::::::::::::::::::::::::::::::::::::::::::::::::::::::::::::::::::::::::::::::::::::::::::::::::::::::::::::::::::::::::::::::::::::::::::::::::::::::::::::
::::::::::::::::::::::::::::::::::::::::::::::::::::::::::::::::::::::::::::::::::::::::::::::::::::::::::::::::::::::::::::::::::::::::::::::::::::::::::::::::
::::::::::::::::::::::::::::::::::::::::::::::::::::::::::::::::::::::::::::::::::::::::::::::::::::::::::::::::::::::::::::::::::::::::::::::::::::::::::::::::
::::::::::::::::::::::::::::::::::::::::::::::::::::::::::::::::::::::::::::::::::::::::::::::::::::::::::::::::::::::::::::::::::::::::::::::::::::::::::::::::
::::::::::::::::::::::::::::::::::::::::::::::::::::::::::::::::::::::::::::::::::::::::::::::::::::::::::::::::::::::::::::::::::::::::::::::::::::::::::::::::
::::::::::::::::::::::::::::::::::::::::::::::::::::::::::::::::::::::::::::::::::::::::::::::::::::::::::::::::::::::::::::::::::::::::::::::::::::::::::::::::
