::::::::::::::::::::::::::::::::::::::::::::::::::::::::::::::::::::::::::::::::
::::::::::::::::::::::::::::::::::::::::::::::::::::::::::::::::::::::::::::::::
::::::::::::::::::::::::::::::::::::::::::::::::::::::::::::::::::::::::::::::::
::::::::::::::::::::::::::::::::::::::::::::::::::::::::::::::::::::::::::::::::
::::::::::::::::::::::::::::::::::::::::::::::::::::::::::::::::::::::::::::::::
::::::::::::::::::::::::::::::::::::::::::::::::::::::::::::::::::::::::::::::::
::::::::::::::::::::::::::::::::::::::::::::::::::::::::::::::::::::::::::::::::
::::::::::::::::::::::::::::::::::::::::::::::::::::::::::::::::::::::::::::::::
::::::::::::::::::::::::::::::::::::::::::::::::::::::::::::::::::::::::::::::::
::::::::::::::::::::::::::::::::::::::::::::::::::::::::::::::::::::::::::::::::
::::::::::::::::::::::::::::::::::::::#:::::::::::::::::::::::::::# ::::::::::::
::::::::::::#:::::::::::::::::::::::::##::::::::::::::::::::::::::#      :::::::
::::::::::::#::::::::::::::::::# :::::##::::::::::::::::::::::::::#            #
::::::::::::#:::::#::::::::::::# :::::##::::::::::::::::::::::::::#            #
::::::::::::# ::::#::::::::::::# :::::##::::::::::::::::::::::::::#            #
::::::::::::# ::::#::::::::::::# :::: ##::::::::::::::::::::::::::#            #
::::::::::::# ::::###::::::::::#  ::: ##::::::::::::::::::::::::::#            #
::::::::::::# :::    :########### ::: ##::::::::::::::::::::::::::##           #
::::::::::::# :::    :    ####### ::  ##:::::::::::::#:::::::::::###           #
::::::::::::#  ::   :::            :  ###::#########################           #
::::::::::::#  :    ::::           :  ###:: ##########                         #
::::::::::::#  :    ::::           :  ###:: ##                                 #
::::::::::::#  :   ::::::             ###::###                                 #
::::::::::::#  :  #:::::::            ###:: ##                                 #
::::::::::::#     ##:::::::###        ###::##                     #            #
::::::::::::#     ###::::::###        ###::#######  ############################
::::::::::::#     # ##:::::###        ###::#####  # ######::::::::::::::::::::::
::::::::::::#    ##  #:::::###        ###::###      ##::::::::::::::::::::::::::
::::::::::::#    ##   :::::###        ###::###      ##::::::::::::::::::::::::::
:::::::#:::###   ##   :::::### #      ###::###      ##:::::::::::::::::#:#::::::
:::::::#:::###   ### #:::::###        ###::##       #######################:::::
:::::: #:::###    #   :::::###        ###::##       #####              :::::::::
:::::: #:::###    ##  :::::###    #   #######       #########     ::::::::::::::
#::::: #:::###    # #::::::###    ### #######                     ::::::::::::::
# :::: #:::###    ## ::::::###        #######                         ::::::::::
#  ::: #:::###    ## ::::::###         ######                    #### #  #::::::
#  ::: #######    ######:::###                 ###########      ##########::::::
#   :  #######   #############  #             ############      ##::::::::::::::
#                 ########### ###             ####### #::::      #::::::::::::::
#                  #           ##             ###::::#::::::     #::::::::::::::
#       #                                     ###:::::::::::::   #::::::::::::::
#                  #                          ###::::::::::::::  #::::::::::::::
#                  #######                    ###::::::::::::::  #::::::::::::::
#                 #########    #              ###:::::::::#::::  #::::::::::::::
#                 ####:: ##    ##             ###::::::::: ::::  #::::::::::::::
#                 ####:: ##                   ###::::::::: :::  ##::::::::::::::
#                 ####:: ##                   ###::::::::: ::   ##::::::::::::::
#                 ####:: ##                   ###:::::::::#:    ##::::::::::::::
#                 ####::###                   ###:::::::::      ##::::::::::::::
#                  ###::###       ###############:::::::::      ##::::::::::::::
#                 ####:####      ##########################     ##::::::::::::::
##               #####::###  ### #########################      ##::::::::::::::
###             ## ###::###  ### ##::::::::::::# #              ##::::::::::::::
# #            ## ####::### ##   ##::::::::::::###              ##::::::::::::::
#               # ####::#####    ## ::::::::::: ##              ##::::::::::::::
#    ############  ## ::###      #################              ##::::::::::::::
#    ##::::::####  ########        #### ########                ##::::::::::::::
#    ##::::::: ##  ########                                     ##::::::::::::::
#    ##::::::: ## ## ####                                       ##::::::::::::::
#    ##::::::: ## ##    ##                                      ##::::::::::::::
#    ##::::::::## ##   ##                                       ##::::::::::::::
#    ##::::::::##  #                                            ##::::::::::::::
#    ##::::::::##  #                                  ############::::::::::::::
#    ##::::::::####################                   ############::::::::::::::
#    ##::::::::####################                   ##::::::::::::::::::::::::
#    ##::::::::#:::#:::::::: ::::##                   ##::::::::::::::::::::::::
#    ##:::::::::::::::::::::#::::##                   ##::::::::::::::::::::::::
#     #::::::::::::::::::::::::::##     ################::::::::::::::::::::::::
#     ##### :::::::::::::::::::::##   ##################::::::::::::::::::::::::
#     #########################::##   ##################::::::::::::::::::::::::
#              #             ##::##   ###:::::::::::### ::::::::::::::::::::::::
#                             #::##   ###:::::::::::####::::::::::::::::::::::::
#                             #::##   ###:::::::::::####::::::::::::::::::::::::
#                             #::##   ###             ##::::::::::::::::::::::::
#                             #::##                    #::::::::::::::::::::::::
#                             #::##                   ##::::::::::::::::::::::::
#                             #::##                    #    #:::::::::::::::::::
#                            ######                        :::::::::::::::::::::
#                                                          #####::::::::::::::::
#################################################################:::::::::::::::
