:::::::::::::::::::#################::::::::::::::::::::::::::::#:::::::::::::::
::::::::::::::::::::   :: :    :   :::::::::::::::::::::::::::::#     ::::::::::
::::::::::::::::::::      :        :::::::::::::::::::::::::::::#         :::  #
:::::::::::::::::::::     :        :::::::::::::::::::::::::::::#:             #
:::::::::::::::::::::             ::::::::::::::::::::::::::::::#:             #
::::::::::::::::::::::            ::::::::::::::::::::::::::::::#              #
::::::::::::::::::::::           ::::::::::#::::#:::::::::::::::#            ::#
:::::::::::::::::::::::          ::::::::: #::::#  :::::::::::::#            ::#
:::::::::::::::::::::::         ::::::::   #::::#   ::::::::::::#              :
:::::::::::::::::::::::         ::::::     #::::#    :::::::::::#              #
::::::::::::::::::::::::       ::::        #::::#      :::::::::#              #
::::::::::::::::::::::::       ::          #::::#        :::::::#              #
:::::#::::::::::::::#:::                   #::::#         ::::::#XxxxxxxX      #
:::: #::::::::::::::#     ::               #::::#           ###:x              #
#::: :::::::::::::::#     :                #::::#           XxxX        :      #
#::: #::::::::::::::#     :                #::::#          x#####      :       #
# : :#::::::::::::::#     :                #::::#         X#::::#              #
# :  #::::::::::::::#                      #::::#         x#::::#           :  #
#    #::::::::::::::#                      #::::#         x#::::#           :  #
#    #::::::::::::::#                      #::::#         x#::::#           :: #
#    #::::::::::::::#                      #::::#         x#::::#          ::: #
#    #::::::::::::::#                      #::::#         x#::::#          ::::#
#    #::::::::::::::#              :       #::::#         x#::::#          ::::#
#    #::::::::::::::#XxxX         ::       #::::#         x#::::#          :::::
#    #::::::::::::::# #  x       ::::      #:::##         x##:::#          :::::
#    ##:#::::::::::::::##:x     ::::::     #::::          x ::::#            :::
#    #:::::::::::::::::::# x   ::::::::    #::::          x##:::#              #
#    #:::::::::::::::::::#  X ::::::::::   #:::#          x ::::#              #
#    ##::::::::::::::::::#  x ::::::::::   #:::#          x##:::#              #
#    #::::#::::::::::::::#  x::::::::::::  #:::#          x #:::#              #
#     ::::# :::#:::::::::#  X::::::::::::: #:::#          x #:::#              #
#     #:::# ::###::::::::#  x::::::::::::::##:##:         x:#:::#              #
#     #:::# : # :::::::::#   X::::::::::::::#             x:::::#              #
#     #:::#     :::::::::#   x:#:::::::::::#:             x#::::#              #
#     #:::#    :#::::::::#   x:::::::::::::::#            x#::::#              #
#     #:::#    ::::::::::#   x :::::::::::::::::          x#::::#              #
#     #:::#     #::::::::#   x       ::::::#:::#          X#::::#              #
#     ####     ::::::::::##: x :  #::::::#::::::         x #::::#              #
#     :::      #:::::::::::: x #::#::::::::::::##       x  #::::#              #
#              #:::::::::::::x##:::::::::::::::##      x   #::::#              #
#              #::::::::::#:#x##:::::::::::::::#      x    #::#:#          #####
#              :#:#::#####:# x##:::::::::::::::#     x     #::###          #::::
#                ##      ##  X##:::::::::::::::#    x                      #::::
#                            x##:::::::::::::::#   x          ::::         #::::
#                             X#:::::::::::::::#  x         ::::::::::     #::::
#              :              x#::::::::::::::::#x          ::::::::::     #::::
#              :              X#:::::#:::::::##:x        :: ::::::::::     #::::
#                             x:######:#:::###xX        ::::#::::::::      #::::
#                              Xxxxxxxxxxxxxxx        :::::::::::::::      #::::
#                                          ####      ::::::::::::::::      #::::
#                                          :::#::    ::::::::::::::::      #::::
#                                          #::::#    :::::::::::::::       #::::
#                                          #::::#    :::::::::::::::       #::::
#             ######## #            :      #::::#    ::::::::::::::   ######::::
#             #:::::##:#                   #::::#    :::::::::::::    #:::::::::
#             #::::::::##                  #::::#   ::::::::::::::    #:::::::::
#             ##::::::::#                  #:::##   ::::::::::::::    #:::::::::
#             ::::::::::#                  #::::#   :::::::::::::     #:::::::::
#             #:::::::::#                  #:::##   :::::::::::::     #:::::::::
#             #:::::::::#                  #::::#   :::::::::::::    :#:::::::::
#             #:::::::::#                  #:::##   :::::::::::::    ##:::::::::
#             #:::::::::#                  #:::#:   :::::::::::::    #::::::::::
#             #:::::::::#                  ##::#:   :::::::::::::    #::::::::::
#             #:::::::::#                  ::::::    ::::::::::::    #::::::::::
#             #:::::::::#                  :::::#       :::::::      ##:::::::::
#             #:::::::::#                  :::::#                     #:::::::::
#             #:::::::::#                  :::::#                ######:::::::::
#             #:::::::::#                  :::::#               :#::::::::::::::
#             #:::::::::#                  :::::#               :#::::::::::::::
#             #:::::::::#                  :#:::#               :#::::::::::::::
#             ##::::::::#                  :#:::#               ##::::::::::::::
#              :::::::::#                   #:::#               ##::::::::::::::
#              #::::::::#                   #:::#               #:::::::::::::::
#             ##::::::::#                   ::::                ##::::::::::::::
#              :::::::::#                   ####                #:::::::::::::::
#              #::::::::#    :::            #                   #:::::::::::::::
#       :      #::::::::#   ::                                  ##::::::::::::::
#     : :    : :::::::::#::::                                    #::::::::::::::
#  :  : : :  ::#:::::::::::                                      #::::::::::::::
##############::::::::::::########################################::::::::::::::
