:::::::::::::::::::::::::::::::::::::::::::::::::::::::::::::::#############::::
::::::::::::::::::::::::::::::::::::::::::::::::::::::::::::::::           :::::
::::::::::::::::::::::::::::::::::::::::::::::::::::::::::::::::           :::::
::::::::::::::::::::::::::::::::::::::::::::::::::::::::::::::::           :::::
::::::::::::::::::::::::::::::::::::::::::::::::::::::::::::::::           :::::
:::::::::::::::::::::::::::::::::::::::::::::::::::::::::::::::::         ::::::
:::::::::::::::::::::::::::::::::::::::::::::::::::::::::::::::::         ::::::
:::::::::::::::::::::::::::::::::::::::::::::::::::::::::::::::::         ::::::
::::::::::::::::::::::::::::::::::::::::::::::::::::::::::::::::::        ::::::
::::::::::::::::::::::::::::::::::::::::::::::::::::::::::::::::::       :::::::
::::::::::::::::::::::::::::::::::::::::::::::::::::::::::::::::::#      :::::::
::::::::::::::::::::::::::::::::::::::::::::::::::::::::::::::::::#      :::::::
#:::::::::::::::::#:::::::::::::::::::::::::::::::::::::::::::::::#            #
#:::::::::::::::::#:::::::::::::::::::::::::::::::::::::::::::::::#            #
# ::::::::::::::::#:::::::::::::::::::::::::::::::::::::::::::::::#            #
# ::::::::::::::: ##::::::::::::::::::::::::::::::::::::::::::::::#            #
# ::::::::::::::: ###:###:#######:::::::::::::::::::::::::::::::::#            #
# :::::#:::::::::  ###           :::::::::::::::::::::::::::::::::#            #
#  :::: ::::::::      :          :::::::::::::::::::::::::::::::::#            #
#  ::::#::::::::     :::         :::::::::::#######################            #
#  ::::#::::#:::     ::::        :::::::::::##########                         #
#  ::::##:::#:::     :::::       :::::::::::#                                  #
##  :: #::::#::     :::::::      :::::::::::#                                  #
##  :: #::::#::     ::::::::#    :::::::::::#                                  #
##  :: #::::# :  ##:::::::::#    :::::::::::#                                  #
##   : ##:::#    ##:::::::::#    :::::::::::#       ############################
##   : # :::#    ##:::::::::#     ::::::::::#        #################::::::::::
##   : #::::#    ##:::::::::#      :::::::::#       ##::::::::::::::::::::::::::
##     ##:::#    ##:::::::::#       ::::::::#       ##::::::::::::::::::::::::::
##     # :::#    ##:::::::::#        :::::::#       ##:::::::::::::::::::  #::::
##     #::::##   ##:::::::::#         ::::::#       ## ######## ##    #   ::::::
##     ##:::##   ##:::::::::#          :::::#              :::::::::::::::::::::
##     # :::##   ##:::::::::#         #######                  :::::::::::::::::
##     ##:::##   ##::::::::##         #######                      :::::::::::::
##     ##:::##   ##::::::::##                                          :::::::::
##     #######   ##::::::::##                                    ##########:::::
##     #######   ########::##                  ###########       ######### #::::
#      ### ##    ############                   #######:::       #::::::::::::::
#                 ###########                   #::: #:::::      #::::::::::::::
#                                               #:::#:::::::     #::::::::::::::
#                                               #::::::::::::    #::::::::::::::
#                                               #:::::::::::::   #::::::::::::::
##                  #####                       #:::::::::::::   #::::::::::::::
##                 ########                     #::::::::::::::  #::::::::::::::
##                 ########                    ##::::::::::::::: #::::::::::::::
##                 ###:::##                    ##::::::::::::::::#::::::::::::::
##                 ###:::##                    ##:::::::::::::::::::::::::::::::
##                 ###:::##                    ##:::::::::::::::::::::::::::::::
##                 ###:::##                    ##:::::::::::::::::::::::::::::::
##                 ###:::##                    ##:::::::::::::::::::::::::::::::
##                 ###:::##       ###############:::::::::::::::::::::::::::::::
##                 ###:::##       ##::::::::::::::::::::::::::::::::::::::::::::
##                 ###:::##       ##::::::::::::::::::::::::::::::::::::::::::::
##                 ###:::##       ##::::::::::::::::::::::::::::::::::::::::::::
##                 ###:::##       ##::::::::::::::::::::::::::::::::::::::::::::
##   ############  ###:::##       ##      #####:::::::::::::::::::::::::::::::::
##   ############  ########              :::::::::::::::::::::::::::::::::::::::
##   ###:::::: ##  # ######                 ::::::::::::::::::::::::::::::::::::
##   ###:::::: ##                              :::::::::::::::::::::::::::::::::
#    ##::::::: ##                                   ::::::::::::::::::::::::::::
#    ##::::::: ##                                       ::::::::::::::::::::::::
#    ##::::::: ##                                       #####:::::::::::::::::::
#    ##::::::: ##                                      #####::::::::::::::::::::
#    ##::::::: ####################                    #::::::::::::::::::::::::
#    ##:::::::#####################                    #::::::::::::::::::::::::
#    ##:::::::::::::::::::::::::::                     #::::::::::::::::::::::::
#    ##:::::::::::::::::::::::::::                     #::::::::::::::::::::::::
#    ##:::::::::#:::::::::::::::::        ############ #::::::::::::::::::::::::
#    ########################:::::     ##############  #::::::::::::::::::::::::
#    #########################:::::    ##::::::::::::: #::::::::::::::::::::::::
#         ####################:::::    ##:::::::::::::::::::::::::::::::::::::::
#                           ##:::::    ##:::::::::::::::::::::::::::::::::::::::
#                           ##:::::    ##:::::::::::::::::::::::::::::::::::::::
#                           ##::::::    #:::::::::::::::::::::::::::::::::::::::
#                           ##::::::      ::::::::::::::::::::::::::::::::::::::
#                           #:::::::      ::::::::::::::::::::::::::::::::::::::
#                           ######::       :::::::::::::::::::::::::::::::::::::
#                           ######  :       ::::::::::::::::::::::::::::::::::::
########          ################################# #:::::::::::::::::::::::::::
###################################################:::::::::::::::::::::::::::::
