:::::::::::::::::::::#:#######:##########################################################################################::::::::#######::###::#::#:::::::::::::
::::::::::::::::::::::         :        :                                                                               #::::::::#    ::: : ::::: ::::::::::::::
::::::::::::::::::::::::                                                                                                :::::::::#             :  ::::::::::::::
:::::::::::::::::::::::::                                                                                              ::::::::::#                  ::::::::::::
::::::::::::::::::::::::::                                                                                             #:::::::::#                           ::#
::::::::::::::::::::::::::::                                                                                           #:::::::::#                :            #
:::::::::::::::::::::::::::::                                                                                          ##::::::::#                             #
::::::::::::::::::::::::::::::                                                                                          #::::::::#                             #
:::::::::::::::::::::::::::::::                                                                                         :::::::::#                             #
:::::::::::::::::::::::::::::::::                                                                                      #:::::::::#                             #
::::::::::::::::::::::::::::::::::                                                                                     #::::::::##                      :      #
:::::::::::::::::::::::::::::::::::                                                                                    #::::::::##                      :      #
::::::::::::::::::::::::::::::::::::                                                                                   #:::::::::                      ::      #
:::::::::::::::::::::::::::::::::::::                                                   ########                       #:::::::::                     :        #
::::::::::::::::::::::::::::::::::::::                                                 #:::::::::                      #:::::::::                              #
:::::::::::::::::::::::::::::::::::::::                                                #::::::::#                      ##:::::::#                              #
:::::::::::::::::::::::::::::::::::::::::                                              #:::::::::                      :::::::::#                              #
::::::::::::::::::::::::::::::::::::::::::                                             #::::::::#                      ::::::::::                              #
:::::::::::::::::::::::::::::::::::::::::::                                            #::::::::#                      #::::::::#                              #
::::::::::::::::::::::::::::::::::::::::::::                                           #:::::::##                      #::::::::#                              #
:::::::::::::::::::::::::::::::::::::::::::::                                          #::::::::#                      #::::::::#                              #
::::::::::::::::::::::::::::::::::::::::::::::                                         #:::::::::                      #:::::::::                              #
::::::::::::::::::::::::::::::::::::::::::::                                           #:::::::::                      #::::::::#                              #
::::::::::::::::::::::::::::::::::::                                                   #:::::::::                      #:::::::::                              #
::::::::::::::::::::::::::::                                                           #:::::::::                      ##::::::::                              #
::::::::::::::::::::##::::::::::::::#:::#                                              #:::::::#:                       :::::::::                              #
::::::::::::::::::::::::::::::::::::::::#                                              #:::::::::                       ########:                              #
::::::::::::::::::::::::::::::::::::::::#                                              #:::::::::                                                              #
:::::::::::::::::::::::::::::::::::::::##                                              #:::::::::                                                              #
::::::::::::::::::::::::::::::::::::::::#                                              #:::::::::                                                              #
::::::::::::::::::::::::::::::::::::::::#                                              #:::::::::                       #########                              #
::::::::::::::::::::::::::::::::::::::::#                                              #:::::::::                      #::::::::#                              #
::::::::::::::::::::::::::::::::::::::::#                                              #:::::::::                      #::::::::#                              #
::::::::::::::::::::::::::::::::::::::::#                                              #::::::::#                      #::::::::#                              #
::::::::::::::::::::::::::::::::::::::::#                                              #::::::::#                      #::::::::#                              #
::::::::::::::::::::::::::::::::::::::::#                                              #::::::::#                      #::::::::#                              #
::::::::::::::::::::::::::::::::::::::::#                                              #::::::::#                      #::::::::#                              #
::::::::::::::::::::::::::::::::::::::::#                                              ##:::::::#                      #::::::::#                              #
::::::::::::::::::::::::::::::::::::::::#                                              #::::::::#                      #::::::::#                              #
::::::::::::::::::::::::::::::::::::::::#                                              :#:::::::#                      #::::::::#                              #
::::::::::::::::::::::::::::::::::::::::#                                              :::::::::#                      #::::::::#                              #
::::::::::::::::::::::::::::::::::::::::#                                              :::::::::#                      #::::::::#                              #
::::::::::::::::::::::::::::::::::::::::#                                              :::::::::#                      #::::::::#                              #
::::::::::::::::::::::::::::::::::::::::#                                              ::::::::##                      #::::::::#                              #
::::::::::::::::::::::::::::::::::::::::#                                              :::::::::                       #::::::::#                              #
::::::::::::::::::::::::::::::::::::::::#                                              :::::::::                       #::::::::#                              #
::::::::::::::::::::::::::::::::::::::::#                                               ::::::::                       #::::::::#                              #
::::::::::::::::::::::::::::::::::::::::#                                              #::::::::                       #:::::#::#                              #
::::::::::::::::::::::::::::::::::::::::#                                              #::::::::                       #:::  :::#                              #
::::::::::::::::::::::::::::::::::::::::#####:::::                                     #::::::::#                      #::  ::::#                              #
:::::::::::::::::::::::::::::::::::::::::::::::::#                                     #::::::::#                      :  ::::::#                              #
::::::::::::::::::::::::::::::::::::::::::::::::::                                     #::::::::#                        :::::::#                              #
:::::::::::::::::::::::::::::::::::::::::::::::::##                                    #::::::::#                      ###::::::#                              #
::::::::::::::::::::::::::::::::::::::::::::::::::                                     #:::::::##                       ::::::::#                              #
::::::::::::::::::::::::::::::::::::::::::::::::::#                                    #::::::::#                       ::::::::#                              #
::::::::::::::::::::::::::::::::::::::::::::::::::#                                    #:::::::##                      #::::::::#                              #
:::::::::::::::::::::#:::::::::::::::::::::::::::##                                    #::::::::                       #::::::::#                              #
:::::::::::::::::::::#::::::::::::::::::::::::::::                                     #::::::::                       #::::::::#                              #
:::::::::::::::::::::#::::::::::::::::::::::::::::#                                    #::::::::                       #::::::::#                              #
::::::::::::::::::::## ::::::::#::::::::::::::::::#                                    #::::::::                       #::::::::#                              #
::::::::::::::::::::#  :::::::::::::::::::::::::::#                                    #::::::::                       ##:::::::#                              #
::::::::::::::::::::#  :::::::::::::::::::::::::::#                                    #::::::::#                       ::::::::#                              #
#:::::::::::::::::::#   ::::::::::::::::::::::::::#                                    #::::::::#                       ::::::::#                              #
# ::::::::::::::::::#:  ::::::::::::::::::::::::::#                                    #::::::::#                      #::::::::#                              #
# :::::::::::::::::::   :::::: :::::::::::::::::::#                                     ###::::::                      #::::::::#                              #
#  :::::::::::::::::#    ::::: :::::::::::::::::::#                                                                    #::::::::#                              #
#   ::::::::::::::::#    ::::: :::::::::::::::::::#                                                                    #::::::::#                              #
#    :::::::::::::::#    ::::: :::::::::::::::::::#                                                                    #::::::::#                              #
#    :::::::::::::::#    ::::: :::::::::::::::::::#                                                                    #::::::::#                              #
#     ::::::::::::::#     :::: :::::::::::::::::::#                                    ########::                      #::::::::#                              #
#      :::::::::::::#     :::: :::::::::::::::::::#                                    #::::::::#                      #::::::::#                              #
#       ::::::::::::#:    :::: :::::::::::::::::::#                                    #::::::::#                      #::::::::#                              #
#       ::::::::::::#      ::: #::::::::::::::::::#                                    #::::::::#                      #::::::::#                              #
#        :::::::::::#      ::: :::::::::::::::::::#                                    #::::::::#                      #::::::::#                              #
#         ::::::::::#      ::: :::::::::::::::::::#                                    #::::::::#                      #::::::::#                              #
#          :::::::::#       :: :::::::::::::::::::#                   ###       ########::::::::#                      #::::::::#                              #
#          ##########       :  ::::::::::::::::::##:#:###     ::::::::#:::##::###:::::::::::::::#                      #::::::::#                              #
#                 :         :  :::::::::::::::::::::::::#    #::::::::::::::::::::::::::::::::::#                      #::::::::#                              #
#                              :::::::::::::::::::::::::#    #::::::::::::::::::::::::::::::::::#                      #::::::::#                              #
#                              #::::::::::::::::::::::::#    #::::::::::::::::::::::::::::::::::#                      #::::::::#:                             #
#                              :::::::::::::::::::::::::#    #::::::::::::::::::::::::::::::::::#                      #::::::::##                             #
#                              :::::::::::::::::::::::::#    #::::::::::::::::::::::::::::::::::#                      ###########                            ##
#                              :::::::::::::::::::::::::#    :::::::::::::::::::::::::::::::::::#                                                     ##:::#::#:
#                              :::::::::::::::::::::::::#    :::::::::::::::::::::::::::::::::::#                                                     #:::::::::
#                               ########################     :::::::::::::::::::::::::::::::::::#                                                     #:::::::::
#                               :: :                         ##:::::::::::::::::::::::::::::::::#                                                     #:::::::::
#                                                            #::::::::::::::::::::::::::::::::::#                                                     #:::::::::
#                                                             ::::::::::::::::::::::::::::::::::#                                                     #:::::::::
#                                                             ::::::::::::::::::::::::::::::::::#                                                     #:::::::::
#                                                             ::::::::::::::::::::::::::::::::::#                                                     #:::::::::
#                                                             ::::::::::::::::::::::::::::::::::#                                                     #:::::::::
#                                                             ::::::::::::::::::::::::::::::::::#                                                     #:::::::::
#                                                            ##:::::::::::::::::::::::::::::::::#                                                     #:::::::::
#                                                            #::::::::::::::::::::::::::::::::::#                                                     #:::::::::
#                                                             #################################                                                       #:::::::::
#                                                                                                                                                     #:::::::::
#                                                                                                                                                     #:::::::::
#                                                                                        ::                                                           #:::::::::
#                  :                                                                   ####::###                                                      #:::::::::
#                   :                                                                 ##::::::::#                                                     ##::::::::
#             :                                                                       ##::::::::#                                                     #:::::::::
#                                                                                     ##::::::::#                                                     #:::::::::
#           ::::                                                                       #::::::::#                                                     #:::::::::
#           ::::::::                                                                   #::::::::#                                                     #:::::::::
#          :::::::::::                                                                 #:::::::::                                                     #:::::::::
#          ::::::::::                                                                  #:::::::::                                                     #:::::::::
#         ::::::                                                                       #:::::::##                                                     #:::::::::
#      :  :     ::           :###################:                                     #:::::::::                                            ##########:::::::::
#           :::              #::::::::::::::::::#                                      #:::::::##                                           #:::::::::::::::::::
#        ::::    :           #::::::::::::::::::#                                      #::::::::#                                           #:::::::::::::::::::
#    :: ::    ::             #::::::::::::::::::#                                      #::::::::#                                           #:::::::::::::::::::
#   ::      ::               #::::::::::::::::::#                                      #::::::::#                                          ##:::::::::::::::::::
#   :    :::                 #::::::::::::::::::#                                      #::::::::#                                          #::::::::::::::::::::
#      ::::                  #::::::::::::::::::#                                      #::::::::#                                           ::::::::::::::::::::
#   : :::                    #::::::::::::::::::#                                      #::::::::#                                          ##:::::::::::::::::::
# :::       :                #::::::::::::::::::#                                      #::::::::#                                          ##:::::::::::::::::::
#::       :                  #::::::::::::::::::#                                      #::::::::#                                           ::::::::::::::::::::
#:                           #::::::::::::::::::#                                      #::::::::#                                           ::::::::::::::::::::
:                            #::::::::::::::::::#                                      #::::::::#                                           #:::::::::::::::::::
#                            #::::::::::::::::::#                                      #::::::::#                                          ##:::::::::::::::::::
#:                      :    #::::::::::::::::::#:                 :                   #::::::::#                                          #::::::::::::::::::::
:                      ::    #::::::::::::::::::#:                                     #::::::::#                                          #::::::::::::::::::::
#                     :::    #::::::::::::::::::#:                                     #::::::::#                                          #::::::::::::::::::::
#                    ::::    #::::::::::::::::::#:                                     #::::::::#                                           ::::::::::::::::::::
#                   :::::    #::::::::::::::::::#:                                     #::::::::#                                           #:::::::::::::::::::
#                  ::::::    #::::::::::::::::::#:                                     #::::::::#                                          ##:::::::::::::::::::
#                 :::::::    #::::::::::::::::::#:                                     #::::::::#                                          #::::::::::::::::::::
#                ::::::      #::::::::::::::::::#:                                     #::::::::#                                          #::::::::::::::::::::
#         :     :::::        #::::::::::::::::::#:                                     #::::::::#                                          #::::::::::::::::::::
#        :     ::::     :    #::::::::::::::::::#:                                     #::::::::#                                           ::::::::::::::::::::
#       :     :::      ::    #::::::::::::::::::#:                                     #::::::::#                                           #:::::::::::::::::::
#      :     ::       :::    #::::::::::::::::::##                                     #::::::::#                                          ##:::::::::::::::::::
#     :    ::       ::::     #::::::::::::::::::##                                     #::::::::#                                          #::::::::::::::::::::
:    :  :          :::::     #::::::::::::::::::##                                     #::::::::#                                ###########::::::::::::::::::::
#   :  :     :    :::::      #::::::::::::::::::::                                     #::::::::#                                #::::::::::::::::::::::::::::::
#           :   ::::::       #::::::::::::::::::##                                     #::::::::#                                #::::::::::::::::::::::::::::::
#         :    :::::::       #::::::::::::::::::##                                     #::::::::#                                #::::::::::::::::::::::::::::::
#       ::   ::::::::        #:::::::::::::::::::#                                     #::::::::#                                #::::::::::::::::::::::::::::::
#     ::    :::::::::        #:::::::::::::::::::#                                     #::::::::#                                #::::::::::::::::::::::::::::::
#   :::    :::::::::         #:::::::::::::::::::#                                     #::::::::#                                #::::::::::::::::::::::::::::::
#  ::  : ::::::::::          #::::::::::::::::::::                                     #::::::::#                                #::::::::::::::::::::::::::::::
# ::    :::::::::::          #::::::::::::::::::##                                     #::::::::#                               :#::::::::::::::::::::::::::::::
#:  :  :::::::::::           #:::::::::::::::::::#                                     #::::::::#                                #::::::::::::::::::::::::::::::
:  : ::::::::::::            #:::::::::::::::::::#                                     #::::::::#                                #::::::::::::::::::::::::::::::
#:  ::::::::::::             #::::::::::::::::::::                                     #::::::::#                                #::::::::::::::::::::::::::::::
:  :::::::::::::             #::::::::::::::::::::                                     #::::::::#                               :#::::::::::::::::::::::::::::::
#::::::::::::::              #::::::::::::::::::#:                                     #::::::::#                                #::::::::::::::::::::::::::::::
::::::::::::::               #:::::::::::::::::::                                      #::::::::#                                #::::::::::::::::::::::::::::::
:::::::::::::                #::::::::::::::::::::                                     ::::::::::                                #::::::::::::::::::::::::::::::
::::::::::::                 #::::::::::::::::::#:                                     ########:                                :#::::::::::::::::::::::::::::::
:::::::::::                  #::::::::::::::::::##                                     :                                         #::::::::::::::::::::::::::::::
::::::::::                   #::::::::::::::::::::                                     :                                         #::::::::::::::::::::::::::::::
:::::::::                    #::::::::::::::::::::                                                                              :#::::::::::::::::::::::::::::::
::::::::                     #::::::::::::::::::::                                                                               #::::::::::::::::::::::::::::::
:::::                        #::::::::::::::::::##                                                                               #::::::::::::::::::::::::::::::
:::                          #:::::::::::::::::::#                                                                               #::::::::::::::::::::::::::::::
#                            #:::::::::::::::::::#                                                                               #::::::::::::::::::::::::::::::
#:                           #:::::::::::::::::::#                                                                              :#::::::::::::::::::::::::::::::
:                            #:::::::::::::::::::#                                                                               #::::::::::::::::::::::::::::::
##############################:::::::::::::::::::#################################################################################::::::::::::::::::::::::::::::
