::::::::::::::::::::::::::::::::::::::::::###################:::################
::::::::::::::::::::::::::::::::::::::::::                 #::::##   :::   ::  :
:::::::::::::::::::::::::::::::::::::::::                  #::::#:             #
:::::::::::::::::::::::::::::::::::::::::                  ##:::##             #
::::::::::::::::::::::::::::::::::::::::                   ##:::#:             #
::::::::::::::::::::::::::::::::::::::::                    #:::#:             #
:::::::::::::::::::::::::::::::::::::::                     #:::#:             #
:::::::::::::::::::::::::::::::::::::::                     #::##              #
:::::::::::::::::::::::::::::::::::::::                     #::: :             #
:::::::::::::::::::::::::::::::::::::::                     #:::#:             #
::::::::::::::::::::::::::::::::::::::::::                  #:::#:             #
::::::::::::::::::::::::::::::::::::::::::::::              #:::#:             #
:::::::::::::::::::::::::::::::::::::::::::::::#            #:::#:      X      #
:::::::::::::::::::::::::::::::::::::::::::::::#            #:::#:      x      #
:::::::::::::::::::::::::::::::::::::::::::::::#            #:::#       x      #
:::::::::::::::::::::::::::::::::::::::::::::::#            #:::#       x      #
:::::::::::::::::::::::::::::::::::::::::::::::#            #:::#       x      #
:::::::::::::::::::::::::::::::::::::::::::::::#            #:::#       x      #
:::::::::::::::::::::::::::::::::::::::::::::::#            ::::#       x      #
:::::::::::::::::::::::::::::::::::::::::::::::#            #:::#       x      #
:::::::::::::::::::::::::::::::::::::::::::::::#            ::::#       x      #
:::::::::::::::::::::::::::::::::::::::::::::::#            #:::#       x      #
:::::::::::::::::::::::::::        :      :::::             #:::#       x      #
:::::::::::::::::::::::::                 #::::             #:::#       x      #
:::::::::::::::::::::::##                 :::::             #::::       x      #
:::::::::::::::::::::::::                 :::::             #:::#       x      #
::::::::::::::::::::::::::                :#:::             #:::#       x      #
::::::::::::::::::::::::#                  #:::             #:::#       x      #
::::::::::::::::::::::::#                  ::::             #:::#       x      #
::::::::::::::::::::::::#                 :::::             #:::#       X      #
::::::::::::::::::::::::#                 :#::#             #:::#      x       #
::::::::::::::::::::::::#                  ::::             #:::#     x        #
::::::::::::::::::::::::#                  #:::             #:::#    x         #
::::::::::::::::::::::::#                  #:::             #:::#   x          #
::::::::::::::::::::::::#                  ::::             #::##  x           #
::::::::::::::::::::::::#                 : :::             #::#: x            #
::::::::::::::::::::::::#                                   #::::x             #
::::::::::::::::::::::::##     XxxxxxxxxxxxxxxxxxxxxxxxxxxXx#   x              #
::::::::::::::::::::::####    x::                           XxxX               #
:::::::::::::::::::::::::#::#x#:##:####: :                                     #
::::::::::::::::::::::::::::X #::::::::::::::::#                               #
::::::::::::::::::::::::::::  #::::::::::::::::#                             :##
::::::::::::::::::::::::::::  :::::::::::::::::#                           ##:::
::::::::::::::::::::::::::::   ::::::::::::::::#                            ::::
::::::::::::::::::::::::::::   ::::::::::::::::#                            ::::
:::::::::::::::::::::::::::    ::::::::::::::::#                            ::::
:::::::::::::::::::::::::::    ::::::::::::::::#                           #::::
:::::::::::::::::::::::::::    ::::::::::::::::                            #::::
::::::::::::::::::::::::::      :::::::::::::::                            #::::
::::::::::::::::::::::::::      :::::::::::::::                            #::::
::::::::::::::::::::::::::      ::::::::::::::#:                           #::::
:::::::::::::::::::::::::       ::::::::::::::#:                           #::::
::::::::::::::::::::::::::      ::::::::::::::::                           #::::
:::::::::::::::::::::::::        :::::::::::::::                        ####::::
::::::::::::::::::::::::::       :::::::::::::::                       :::::::::
:::::::::::::::::::::::::::::::::::::::::::::: :                      #:::::::::
:::::::::::::::::::::::::::::::::::::::::::::: :                      #:::::::::
:::::::::::::::::::::::::::::::::::::::::::::: :                      #:::::::::
:::::::::::::::::::::::::::::::::::::::::::::: :                      #:::::::::
:::::::::::::::::::::::::::::::::::::::::::::##:                      #:::::::::
:::::::::::::::::::::::::::::::::::::::::::::::#                      #:::::::::
:::::::::::::::::::::::::::::::::::::::::::::::#                      #:::::::::
:::::::::::::::::::::::::::::::::::::::::::::::#                      #:::::::::
:::::::::::::::::::::::::::::::::::: :::::::::##                      #:::::::::
::::::::::::::::::::::::::::::::::::     :::##                        #:::::::::
:::::::::::::::::::::::::::::::::::                                   #:::::::::
:::::::::::::::::::::::::::::::::::                                  ##:::::::::
:::::::::::::::::::::::::::::::::::::::###:####                   ::::::::::::::
:::::::::::::::::::::::::::::::::::::::::::::::#                 #::::::::::::::
:::::::::::::::::::::::::::::::::::::::::::::::#                 #::::::::::::::
:::::::::::::::::::::::::::::::::::::::::::::::#                 #::::::::::::::
:::::::::::::::::::::::::::::::::::::::::::::::#                 #::::::::::::::
:::::::::::::::::::::::::::::::::::::::::::::::#                 #::::::::::::::
:::::::::::::::::::::::::::::::::::::::::::::::#                 #::::::::::::::
:::::::::::::::::::::::::::::::::::::::::::::::#                 #::::::::::::::
:::::::::::::::::::::::::::::::::::::::::::::::#                 :::::::::::::::
:::::::::::::::::::::::::::::::::::::::::::::::#                 #::::::::::::::
:::::::::::::::::::::::::::::::::::::::::::::::#                 #::::::::::::::
:::::::::::::::::::::::::::::::::::::::::::::::#                ##::::::::::::::
:::::::::::::::::::::::::::::::::::::::::::::::###############  #:::::::::::::::
