#::::::::::::::::::::::::::::################################:::########:#::::::
#  :   :::::::::::::::::::::                                #:::#:     : ::::  #
#         :::::::::::::::::                                 #:::#:             #
#            ::::::::::::::                                 #:::#:             #
#                :::::::::                                  #:::#              #
#                                                           #:::#              #
#                                                           #:::#              #
#                                                           #:::#             :#
#                                                           #:::#              #
#                                                           #:::#              #
#                                                           #:::#              #
#                                            #:            :#:::#             :#
#          :#############                  :::::           :#:::#              #
#         #::::::::::::::                  ::::#           :#:::#              #
#         #::::::::::::::                  ::::#:          ##:::#              #
#         #::::::::::::::                  ::::#:          ##:::#              #
#         #::::::::::::::                  ::::#            #:::#              #
#         #:::::::::::::#                  #:::#           ##:::#              #
#         #:::::::::::::#                  ::::#           :#:::#              #
#         #:::::::::::::#                 :::::#            #:::#              #
#         #:::::::::::::#                  #:::#            #:::#              #
#         #:::::::::::::#                  #:::#            #:::#              #
#         #:::::::::::::#                  #:::#           ##:::#              #
#    :    #:::::::::::::#                  #:::#            #:::#              #
#    ::   ::::::::::::::#                  #:::#            #:::#              #
#    ::   ::::::::::::::#                  #:::#            #:::#              #
# :  :::  ::::::::::::::#                  #:::#           :#:::#              #
# :: :::: #:::::::::::::                   #:::#            #:::#              #
# ::::::: #:::::::::::::                   #:::#            ::::#             :#
# ::::::::#:::::::::::::                   #:::#            #:::#              #
#::::::::::::::::::::::                    #:::#           :#:::#              #
#::::::::::::::::::::::                    #:::#           :#:::#              #
#:::::::::::::::::::::: :                  #:::#            #::::              #
:::::::::::::::::::::: #                   #:::#            #::::              #
:::::::::::::::::::::: :                   #:::#            #::::              #
::::::::::::::::::::::::                   #:::#            #::::              #
:::::::::::::::::::::::::                  :#::#            #::::              #
:::::::::::::::::::::::#:#                                  #:##:              #
::::::::::::::::::::::::#####  :##:                          ::                #
::::::::::::::::::::::::::::# ::::::::##::#####:                               #
::::::::::::::::::::::::::::# :::::::::::::::::#                               #
::::::::::::::::::::::::::::#::::::::::::::::::#                           ###:#
:::::::::::::::::::::::::::::::::::::::::::::::#                           #::::
:::::::::::::::::::::::::::::::::::::::::::::::#                           #::::
::::::::::::::::::::::::::::::::::::::::::::::::                           #::::
:::::::::::::::::::::::::::::::::::::::::::::::#                           #::::
::::::::::::::::::::::::::::::::::::::::::::::::                           #::::
:::::::::::::::::::::::::::::::::::::::::::::::#                           #::::
:::::::::::::::::::::::::::::::::::::::::::::::#                           #::::
::::::::::::::::::::::::::::::::::::::::::::::::                           #::::
::::::::::::::::::::::::::::::::::::::::::::::::#                          #::::
:::::::::::::::::::::::::::::::::::::::::::::::##                          #::::
::::::::::::::::::::::::::::::::::::::::::::::::#                         :#::::
::::::::::::::::::::::::::::::::::::::::::::::::#                     ######::::
::::::::::::::::::::::::::::::::::::::::::::::::#                     #:::::::::
::::::::::::::::::::::::::::::::::::::::::::::::#                     #:::::::::
::::::::::::::::::::::::::::::::::::::::::::::::#                     #:::::::::
::::::::::::::::::::::::::::::::::::::::::::::::#                     #:::::::::
::::::::::::::::::::::::::::::::::::::::::::::::#                   : #:::::::::
::::::::::::::::::::::::::::::::::::::::::::::::#                  :::::::::::::
::::::::::::::::::::::::::::::::::::::::::::::::#               : ::::::::::::::
::::::::::::::::::::::::::::::::::::::::::::::::# :         ::::::::::::::::::::
::::::::::::::::::::::::::::::::::::::::::::::::::::::::::::::::::::::::::::::::
::::::::::::::::::::::::::::::::::::::::::::::::::::::::::::::::::::::::::::::::
::::::::::::::::::::::::::::::::::::::::::::::::::::::::::::::::::::::::::::::::
::::::::::::::::::::::::::::::::::::::::::::::::::::::::::::::::::::::::::::::::
::::::::::::::::::::::::::::::::::::::::::::::::::::::::::::::::::::::::::::::::
::::::::::::::::::::::::::::::::::::::::::::::::::::::::::::::::::::::::::::::::
::::::::::::::::::::::::::::::::::::::::::::::::::::::::::::::::::::::::::::::::
::::::::::::::::::::::::::::::::::::::::::::::::::::::::::::::::::::::::::::::::
::::::::::::::::::::::::::::::::::::::::::::::::::::::::::::::::::::::::::::::::
::::::::::::::::::::::::::::::::::::::::::::::::::::::::::::::::::::::::::::::::
::::::::::::::::::::::::::::::::::::::::::::::::::::::::::::::::::::::::::::::::
::::::::::::::::::::::::::::::::::::::::::::::::::::::::::::::::::::::::::::::::
::::::::::::::::::::::::::::::::::::::::::::::::::::::::::::::::::::::::::::::::
::::::::::::::::::::::::::::::::::::::::::::::::::::::::::::::::::::::::::::::::
::::::::::::::::::::::::::::::::::::::::::::::::::::::::::::::::::::::::::::::::
::::::::::::::::::::::::::::::::::::::::::::::::::::::::::::::::::::::::::::::::
::::::::::::::::::::::::::::::::::::::::::::::::::::::::::::::::::::::::::::::::
::::::::::::::::::::::::::::::::::::::::::::::::::::::::::::::::::::::::::::::::
