:::::::::::::::::::::::::::::::::::::::::::::::::##########:::::#:::::::::::::::
:::::::::::::::::::::::::::::::::::::::::::::::::: ::: :  :#::::#      :::::::::
::::::::::::::::::::::::::::::::::::::::::::::::::  ::     :::::#         :::: #
::::::::::::::::::::::::::::::::::::::::::::::::::         :::::#              #
:::::::::::::::::::::::::::::::::::::::::::::::::::        :::::#              #
:::::::::::::::::::::::::::::::::::::::::::::::::::       #:::::#              #
::::::::::::::::::::::::::::::::::::::::::::::::#:::      #:::::#            ::#
::::::::::::::::::::::::::::::::::::::::::::::::#  :      ##::::#           :::#
:::::::::::::::::::::::::::::::::::::::::::::::##          #::::#           ::::
::::::::::::::::::::::::::::::::::::::::::::::::           #::::#            :::
::::::::::::::::::::::::::::::::::::::::::::::::#          #::::#          :   :
::::::::::::::::::::::::::::::::::::::::::::::::#          #::::#          ::: #
::::::::::::::::::::::::::::::::::::::::::::::::#          #:### XxxxxxxX  ::::#
::::::::::::::::::::::::::::::::::::::::::::::::#           ##: x         ::::::
::::::::::::::::::::::::::::::::::::::::::::::::#           XxxX          ::::::
::::::::::::::::::::::::::::::::::::::::::::::::#          x ####         ::::::
::::::::::::::::::::::::::::::::::::::::::::::::#         X:::::#        :::::::
::::::::::::::::::::::::::::::::::::::::::::::::#         x#::::#        :::::::
::::::::::::::::::::::::::::::::::::::::::::::::#         x#::::#        :::::::
::::::::::::::::::::::::::::::::::::::::::::::::#         x#::::#       ::::::::
::::::::::::::::::::::::::::::::::::::::::::::::#         x#::::#       ::::::::
::::::::::::::::::::::::::::::::::::::::::::::::#         x #:::#       ::::::::
::::::::::::::::::::::::::::::::::::::::::::::::#         X #:::#      #::::::::
::::::::::::::::::::::::::::::::::::::::::::::::         x ##:::#      :::::::::
:::::::::::::::::::::::::#::::::::::::::::::::::        x  #::::#      :::::::::
:::::::::::::::::::::::::# :::::::::::::::::::::       x   #::::#      :::::::::
:::::::::::::::::::::::::# ::::::::::::::::::::::     x     ::::#     ::::::::::
:::::::::::::::::::::::::#  :::::::::::::::::::::    x      ::::#     ::::::::::
:::::::::::::::::::::::::#   :::::::::::::::::: :   x      ###::#     ::::::::::
:::::::::::::::::::::::::#   :::::::::::::::::: #  x       #::::#     ::::::::::
:::::::::::::::::::::::::#    ::::::::::::::::: # x        :::::#          :::::
:::::::::::::::::::::::::#    :::::::::::::::::  x         :#:::#              #
:::::::::::::::::::::::::#      :::::::::::####:x          ##:::#              #
:::::::::::::::::::::::::#        :::::::XxxxxxX           #::::#              #
:::::::::::::::::::::::::#         :::xXx   ####           #::::#              #
:::::::::::::::::::::::::#      Xxxxxx      ::::#          #::::#             :#
:::::::::::::::::::::::::#     x           #::::#          #::::#             :#
:::::::::::::::::::::::::#    x ############::::#          #::::#             :#
::::::::::::::::::::::::::::#X::::::::::::::::::#          #::::#             :#
::::::::::::::::::::::::::::#x#:::::::::::::::::#          #::::#              #
::::::::::::::::::::::::::::#x#:::::::::::::::::#          #::::#          #####
:::::::::::::::::::::::::::: x#:::::::::::::::::#          ######          #::::
::::::::::::::::#::::::::::: x#:::::::::::::::::#                          #::::
::::::::::::::::::      :::  x#:::::::::::::::::#                          #::::
::::::::::::::::::::::       x#:::::::::::::::::#               :          #::::
:::::::::::::::::::::::::    X#:::::::::::::::::#              :::         #::::
::::::::::::::::::::::::::  x #::::::#::#:####::               ::          #::::
:::::::::::::::::::::::::   ::#:::::::                         :           #::::
:::::::::::::::::::::::::  :::::::::::::::::                  :            #::::
::::::::::::::::::::::::   ::::::::::::::::######                          #::::
:::::::::::::::::::::::   ::::::::::::::::::::::#                          #::::
::::::::::::::::::::::    ::::::::::::::::::::::#            :             #::::
::::::::::::::::::::::   :::::::::::::::::::::::#          :::             #::::
:::::::::::::::::::::###::::::::::::::::::::::::#         :::::       ######::::
::::::::::::::::::::::::::::::::::::::::::::::::#       ::::::::      #:::::::::
::::::::::::::::::::::::::::::::::::::::::::::::#      ::::::::::     #:::::::::
::::::::::::::::::::::::::::::::::::::::::::::::#    :::::::::::::    #:::::::::
::::::::::::::::::::::::::::::::::::::::::::::::#   :::::::::::::::   #:::::::::
::::::::::::::::::::::::::::::::::::::::::::::::#   ::::::::::::::::  #:::::::::
::::::::::::::::::::::::::::::::::::::::::::::::#   ::::::::::::::::: #:::::::::
::::::::::::::::::::::::::::::::::::::::::::::::#   ::::::::::::::::::#:::::::::
::::::::::::::::::::::::::::::::::::::::::::::::#   ::::::::::::::::::::::::::::
::::::::::::::::::::::::::::::::::::::::::::::::#   ::::::::::::::::::::::::::::
::::::::::::::::::::::::::::::::::::::::::::::::#   ::::::::::::::::::::::::::::
::::::::::::::::::::::::::::::::::::::::::::::::#     ::::::::::::::::::::::::::
::::::::::::::::::::::::::::::::::::::::::::::::#          :::::::::::::::::::::
::::::::::::::::::::::::::::::::::::::::::::::::#             ::#:::::::::::::::
::::::::::::::::::::::::::::::::::::::::::::::::#              :#:::::::::::::::
::::::::::::::::::::::::::::::::::::::::::::::::#               #:::::::::::::::
::::::::::::::::::::::::::::::::::::::::::::::::#               #:::::::::::::::
::::::::::::::::::::::::::::::::::::::::::::::::#               #:::::::::::::::
::::::::::::::::::::::::::::::::::::::::::::::::#               #:::::::::::::::
::::::::::::::::::::::::::::::::::::::::::::::::#               #:::::::::::::::
::::::::::::::::::::::::::::::::::::::::::::::::#               #:::::::::::::::
::::::::::::::::::::::::::::::::::::::::::::::::                #:::::::::::::::
::::::::::::::::::::::::::::::::::::::::::::::                  #:::::::::::::::
::::::::::::::::::::::::::::::::::::::::::::                    #:::::::::::::::
::::::::::::::::::::::::::::::::::::::::::                    ::#:::::::::::::::
::::::::::::::::::::::::::::::::::::::::                       :::::::::::::::::
:::::::::::::::::::::::::::::::::::::::#########################::::::::::::::::
