##############################################################################################::############::::::::::::::::::::::::::::::::::::::::::::::::::::
##                                                                                          ::::::::::::::::####::::::::::::::::::##::::::::::::::::::::::    ::
##                                                                                            ::::::::::::::  ##::::::::::::::::::##::::::::::::::::          ##
##                                                                                            ::::::::::      ##::::::::::::::::::##::::::::                  ##
##                                                                                            ::::::::::      ##::::::::::::::::::##::::::::                  ##
##                                                                                              ::::::        ##::::::::::::::::::##::::                      ##
##                                                                                            ::              ##::::::::::::::::::##                          ##
##          ######::::##::::                                                                                  ##::::::::::::::::::##                          ##
##          ::::::::####::::                                                                                  ##::::::::::::::::::##                          ##
##          ::::::::::::::::::  ::                                                                            ##::::::::::::::::::##                          ##
##          ::::::::::::::::::####                                                                            ##::::::::::::::::::##                          ##
##          ##::::::::::::::::##::                                                                            ##::::::::::::::::::##                          ##
##          ::::::::::::::::::##::                                                                            ##::::::::::::::::::##                          ##
##          ##::::::::::::::::##::                                                                            ##::::::::::::::::::##                          ##
##          ::::::::::::::::::##::                                                                            ##::::::::::::::::::##                          ##
##          ::::::::::::::::::##::                                                                            ##::::::::::::::::::##                          ##
##            ::::::::::::::::::::                                          ::::::::::::::::##                ##::::::::::::::::::##                          ##
##          ::##::::::::::::::##                                        ::##::::::::::::::::##                ##::::::::::::::::::##                          ##
##          ::::::::::::::::::##::                                      ::##::::::::::::::::##                ##::::::::::::::::::##                          ##
##          ::::::::::::::::::##::                                      ::::::::::::::::::::##                ##::::::::::::::::::##                          ##
##          ::::::::::::::::::##::                                      ##::::::::::::::::::##                ##::::::::::::::::::##                          ##
##          ::##::::::::::::::##::                                      ##::::::::::::::::::##                ##::::::::::::::::::##                          ##
##            ::::::::::::::::##::                                      ::::::::::::::::::::::                ##::::::::::::::::::##                          ##
##          ::::::::::::::::::##::                                      ::::::::::::::::::####                ##::::::::::::::::::##                          ##
##        ####::::::::::::::::##::                                      ::::::::::::::::::####                ::::::::::::::::::::##                          ##
##        ##::::::::::::::::::##                                          ::::::::::::::::::##                ::::::::::::::::::::##                          ##
##        ##::::::::::::::::::##                                          ::::::::::::::::::##                ##::::::::::::::::::##                          ##
##        ##::::::::::::::::::##                                        ::::::::::##::::::::##                ##::::::::::::::::::##                          ##
##          ##::::::::::::::::##                                          ::::######::::::::##                ##::::::::::::::::::##                          ##
##          ::::::::::::::::::##                                          ::      ####::::::##                ##::::::::::::::::::##                          ##
##          ::::::::::::::::::##                                                  ::##::::::##                ##::::::::::::::::::##                          ##
##          ::::::::::::::::::##                                                  ::##::::::##                ##::::::::::::::::::##                          ##
##          ::::::::::::::::::##                                                  ::##::::::##                ##::::::::::::::::::##                          ##
##          ::::::::::::::::::##                                                  ##::::::::##                ##::::::::::::::::::##                          ##
##          ::::::::::::::::::##                                                  ####::::::##                ##::::::::::::::::::##                          ##
##          ::::::::::::::::::##                                                  ##::::::::##                ##::::::::::::::::::##                          ##
##            ::::::::::::::::##                                                  ##::::::::##                ##::::::::::::::::::##                          ##
##          ::::::::::::::::::##                                                  ##::::::::##                ##::::::::::::::::::##                          ##
##          ::::::::::::::::::##                                                  ::##::::::##                ##::::::::::::::::::##                          ##
##          ::::::::::::::::::##                                                    ::::::::##                ::::::::##::::::::##::                          ##
##          ::::::::::::::::::##                    ####::                          ::######::                                                                ##
##          ::::::::::::::::::##                  ##::::::##                                                                                                  ##
##          ::::::::::::::::::##                  ::::::::##::                                                                                                ##
##          ::##::::::::::::::##                  ::::::::##::                                                                                                ##
##          ##::::::::::::::::##                  ##::::::##::                                                                                                ##
##          ::::::::::::::::::::                  ::::::::##::                                                                                                ##
##          ::##############::                    ####::::##::                                                                                                ##
##                                                ##::::::::##                                                                                                ##
##                                                ##::::::##::                                                                                                ##
##                                                ##::::::::::                                                                                                ##
##                                                ##::::::::::                                                                                                ##
##                                                ##::::::::##                                ::::                                                  ######    ##
##                                                ##::::::::##                          ::::    ::                                                  ########  ##
##                                      ::::::::::::::::::::::                        ##::::::::##                                                  ##::::::::##
##                                      ::##::::::::::::::::::                        ##::::::::##                                                  ##::::::::##
##                                      ::::::::::::::::::####                        ##::::::::::                                                ::##::::::::::
##                                      ::::::::::::::::::::                          ##::::::####                                                ::::::::::::::
##                                      ##::::::::::::::::##::                        ####::::::##                                                ::##::::::::::
##                                      ##::::::::::::::::##::                        ::::::::::::                                                ::##::::::::::
##                                      ##::::::::::::::::##                            ::::::##::                                                ::##::::::::::
##                                      ##::::::::::::::::##                          ##::::::##::                                                ##::::::::::::
##                                      ##::::::::::::::::##                            ::::::##::                                                ##::::::::::::
##                                      ##::::::::::::::::##                            ##::::##::                                                ##::::::::::::
##                                      ##::::::::::::::::##                              ####                                                    ##::::::::::::
##                                      ##::::::::::::::::##                                                                                  ::::##::::::::::::
##                                ########::::::::::::::####                                                                      ##################::::::::::::
##                            ::##::::::::::::::::::::::::##                                                                  ::##::::::##::::::::::::::::::::::
##                            ::##::::::::::::::::::::::::##                                                                  ::##::::::::::::::::::::::::::::::
##                            ::::::::::::::::::::::::::::##                                                                  ::##::::::::::::::::::::::::::::::
##                            ::::::::::::::::::::::::::::##                                                                  ::##::::::::::::::::::::::::::::::
##                            ::##::::::::::::::::::::::::##                                                                  ::##::::::::::::::::::::::::::::::
##                              ::::::::::::::::::::::::::##                                                                  ::##::::::::::::::::::::::::::::::
##                            ::::::::::::::::::::::::::::##                                                                  ::##::::::::::::::::::::::::::::::
##                            ##::::::::::::::::::::::::::##                                                                  ####::::::::::::::::::::::::::::::
##                            ##::::::::::::::::::::::::::##                                                                  ####::::::::::::::::::::::::::::::
##                            ##::::::::::::::::::::::::::::                                                                  ####::::::::::::::::::::::::::::::
##                            ##::::::::::::::::::::::::::                                                                    ####::::::##::::::::::::::::::::::
##                              ::::::::::::::::::::::::::                                                                      ##::::::::::::::::::::::::::::::
##                                            ::::::::                                                                            ::::::::::::::::::::::::::::::
##################################################::##::################################################################################::::##::::::::::::::::::
