::::::::::::::::::::::::::::::::::::::::::::::::::::::::::::::::#:::::::::::::::
::::::::::::::::::::::::::::::::::::::::::::::::::::::::::::::::#:    ::::::::::
::::::::::::::::::::::::::::::::::::::::::::::::::::::::::::::::#         ::   #
::::::::::::::::::::::::::::::::::::::::::::::::::::::::::::::::#              #
::::::::::::::::::::::::::::::::::::::::::::::::::::::::::::::::#:             #
::::::::::::::::::::::::::::::::::::::::::::::::::::::::::::::::#              #
::::::::::::::::::::::::::::::::::::::::::::::::::::::::::::::::#            : #
::::::::::::::::::::::::::::::::::::::::::::::::::::::::::::::::#            : #
::::::::::::::::::::::::::::::::::::::::::::::::::::::::::::::::#              #
::::::::::::::::::::::::::::::::::::::::::::::::#:::::::::::::::#             :#
::::::::::::::::::::::::::::::::::::::::::::::::#    :::::::::::#            ::#
::::::::::::::::::::::::::::::::::::::::::::::::#       ::::::::#             :#
::::::::::::::::::::::::::::::::::::::::::::::::#          :####           :   :
::::::::::::::::::::::::::::::::::::::::::::::::#::           ::            :  #
::::::::::::::::::::::::::::::::::::::::::::::::#:                           : #
::::::::::::::::::::::::::::::::::::::::::::::::#:::         ###          :    #
::::::::::::::::::::::::::::::::::::::::::::::::#          :::::#             :#
::::::::::::::::::::::::::::::::::::::::::::::::#:        ::::::#      :       :
::::::::::::::::::::::::::::::::::::::::::::::::#:   :   :::::::#      :::     #
::::::::::::::::::::::::::::::::::::::::::::::::#::::  :::::::::#     ::::::   #
::::::::::::::::::::::::::::::::::::::::::::::::::::  ::::::::::#     :::::::  #
:::::::::::::::::::::::::::::::::::::::::::::::::::  :::::::::::#     :::::::: #
:::::::::::::::::::::::::::::::::::::::::::::::::  :::::::::::::#    ::::::::::#
::::::::::::::::::::::::::::::::::::::::::::::::#:::::::::::::::#    :::::::::::
::::::::::::::::::::::::::::::::::::::::::::::::::::::::::::::::#    :::::::::::
::::::::::::::::::::::::::::::::::::::::::::::::::::::::::::::::#    :::::::::::
::::::::::::::::::::::::::::::::::::::::::::::::::::::::::::::::#   ::::::::::::
::::::::::::::::::::::::::::::::::::::::::::::::::::::::::::::::#   ::::::::::::
::::::::::::::::::::::::::::::::::::::::::::::::::::::::::::::::#   ::::::::::::
::::::::::::::::::::::::::::::::::::::::::::::::::::::::::::::::#  :::::::::::::
:::::::::::::::::::::::::::::::::::::::::::::::::::::::::::::::::  :::::::::::::
::::::::::::::::::::::::::::::::::::::::::::::::::::::::::::::::#  :::::::::::::
::::::::::::::::::::::::::::::::::::::::::::::::::::::::::::::::#  :::::::::::::
::::::::::::::::::::::::::::::::::::::::::::::::::::::::::::::::# ::::::::::::::
::::::::::::::::::::::::::::::::::::::::::::::::::::::::::::::::# ::::::::::::::
::::::::::::::::::::::::::::::::::::::::::::::::::::::::::::::::# ::::::::::::::
::::::::::::::::::::::::::::::::::::::::::::::::::::::::::::::::: ::::::::::::::
::::::::::::::::::::::::::::::::::::::::::::::::::::::::::::::::#:::::::::::::::
::::::::::::::::::::::::::::::::::::::::::::::::::::::::::::::::::::::::::::::::
::::::::::::::::::::::::::::::::::::::::::::::::::::::::::::::::::::::::::::::::
::::::::::::::::::::::::::::::::::::::::::::::::::::::::::::::::::::::::::::::::
::::::::::::::::::::::::::::::::::::::::::::::::::::::::::::::::::::::::::::::::
::::::::::::::::::::::::::::::::::::::::::::::::::::::::::::::::::::::::::::::::
::::::::::::::::::::::::::::::::::::::::::::::::::::::::::::::::::::::::::::::::
::::::::::::::::::::::::::::::::::::::::::::::::::::::::::::::::::::::::::::::::
::::::::::::::::::::::::::::::::::::::::::::::::::::::::::::::::::::::::::::::::
::::::::::::::::::::::::::::::::::::::::::::::::::::::::::::::::::::::::::::::::
::::::::::::::::::::::::::::::::::::::::::::::::::::::::::::::::::::::::::::::::
::::::::::::::::::::::::::::::::::::::::::::::::::::::::::::::::::::::::::::::::
::::::::::::::::::::::::::::::::::::::::::::::::::::::::::::::::::::::::::::::::
::::::::::::::::::::::::::::::::::::::::::::::::::::::::::::::::::::::::::::::::
::::::::::::::::::::::::::::::::::::::::::::::::::::::::::::::::::::::::::::::::
::::::::::::::::::::::::::::::::::::::::::::::::::::::::::::::::::::::::::::::::
::::::::::::::::::::::::::::::::::::::::::::::::::::::::::::::::::::::::::::::::
::::::::::::::::::::::::::::::::::::::::::::::::::::::::::::::::::::::::::::::::
::::::::::::::::::::::::::::::::::::::::::::::::::::::::::::::::::::::::::::::::
::::::::::::::::::::::::::::::::::::::::::::::::::::::::::::::::::::::::::::::::
::::::::::::::::::::::::::::::::::::::::::::::::::::::::::::::::::::::::::::::::
::::::::::::::::::::::::::::::::::::::::::::::::::::::::::::::::::::::::::::::::
::::::::::::::::::::::::::::::::::::::::::::::::::::::::::::::::::::::::::::::::
::::::::::::::::::::::::::::::::::::::::::::::::::::::::::::::::::::::::::::::::
::::::::::::::::::::::::::::::::::::::::::::::::::::::::::::::::::::::::::::::::
::::::::::::::::::::::::::::::::::::::::::::::::::::::::::::::::::::::::::::::::
::::::::::::::::::::::::::::::::::::::::::::::::::::::::::::::::::::::::::::::::
::::::::::::::::::::::::::::::::::::::::::::::::::::::::::::::::::::::::::::::::
::::::::::::::::::::::::::::::::::::::::::::::::::::::::::::::::::::::::::::::::
::::::::::::::::::::::::::::::::::::::::::::::::::::::::::::::::::::::::::::::::
::::::::::::::::::::::::::::::::::::::::::::::::::::::::::::::::::::::::::::::::
::::::::::::::::::::::::::::::::::::::::::::::::::::::::::::::::::::::::::::::::
::::::::::::::::::::::::::::::::::::::::::::::::::::::::::::::::::::::::::::::::
::::::::::::::::::::::::::::::::::::::::::::::::::::::::::::::::::::::::::::::::
::::::::::::::::::::::::::::::::::::::::::::::::::::::::::::::::::::::::::::::::
::::::::::::::::::::::::::::::::::::::::::::::::::::::::::::::::::::::::::::::::
::::::::::::::::::::::::::::::::::::::::::::::::::::::::::::::::::::::::::::::::
::::::::::::::::::::::::::::::::::::::::::::::::::::::::::::::::::::::::::::::::
::::::::::::::::::::::::::::::::::::::::::::::::::::::::::::::::::::::::::::::::
::::::::::::::::::::::::::::::::::::::::::::::::::::::::::::::::::::::::::::::::
::::::::::::::::::::::::::::::::::::::::::::::::::::::::::::::::::::::::::::::::
::::::::::::::::::::::::::::::::::::::::::::::::::::::::::::::::::::::::::::::::
::::::::::::::::::::::::::::::::::::::::::::::::::::::::::::::::::::::::::::::::
