::::::::::::::::::::::::::::::::::::::::::::::::::::########::::###:::::::::::::
::::::::::::::::::::::::::::::::::::::::::::::#######      #:#::##            ::
:::::::::::::::::::::::::::::::::::::::::::::              # #::##             #
::::::::::::::::::::::::::::::::::::::::::::                 #::##             #
::::::::::::::::::::::::::::::::::::::::::                  ::::#:             #
::::::::::::::::::::::::::::::::::::::::::                  #:::#:             #
:::::::::::::::::::::::::::::::::::::::::                   #:::#:             #
::::::::::::::::::::::::::::::::::::::::                    #:::#:             #
::::::::::::::::::::::::::::::::::::::::                    ::::#:             #
::::::::::::::::::::::::::::::::::::::::::                 #::::#:             #
::::::::::::::::::::::::::::::::::::::::::::               #::::#:             #
::::::::::::::::::::::::::::::::::::::::::::::             #::::#              #
::::::::::::::::::::::::::::::::::::::::::::::::           ##:::#              #
:::::::::::::::::::::::::::::::::::::::::::::::#            #:::#              #
:::::::::::::::::::::::::::::::::::::::::::::::#            #  :#              #
:::::::::::::::::::::::::::::::::::::::::::::::#            :  :#              #
:::::::::::::::::::::::::::::::::::::::::::::::#               :#              #
:::::::::::::::::::::::::::::::::::::::::::::::#              ::#              #
::::::::::::::::::::::::::::::::::::::::::::::#              #::#              #
::::::::::::::::::::::::::::::::::::::::::::::##             :::#              #
:::::::::::::::::::::::::::::::::::::::::::::::#            ##::#              #
::::::::::::::::::::::::::::::::::::::::::::::::            :#::#              #
:::::::::::::::::::::::::::::::::::::::::::::::              #::#              #
::::::::::::::::::::::::::::::::::::::::::::::#             :#::#              #
::::::::::::::::::::::::::::::::::::::::::::::#             ::::#              #
::::::::::::::::::::::::::::::::::::::::::::::#             ##::#              #
::::::::::::::::::::::::::::::::::::::::::::::#             #:::#              #
:::::::::::::::::::::::::::::::::::::::::::::::#            #:::#              #
:::::::::::::::::::::::::::::::::::::::::::::::#            ::::#              #
:::::::::::::::::::::::::::::::::::::::::::::::#           #::::#              #
:::::::::::::::::::::::::::::::::::::::::::::::             ::::#              #
:::::::::::::::::::::::::::::::::::::::::::::::             ::::#              #
:::::::::::::::::::::::::::::::::::::::::::::#              ::::#              #
:::::::::::::::::::::::::::::::::::::::::::::#:#            #:::#              #
::::::::::::::::::::::::::::::::::::::::::::::              #:::#              #
:::::::::::::::::::::::::::::::::::::::::                   #:::#              #
::::::::::::::::::::::::::::::::::::::  ######:              ::                #
::::::::::::::::::::::::::::::::::::::       :                                 #
:::::::::::::::::::::::::::::::::::::::::::                                    #
::::::::::::::::::::::::::::::::::::::::::::  ::                               #
:::::::::::::::::::::::::::::::::::::::::::::::#                            ####
:::::::::::::::::::::::::::::::::::::::::::::::#                           #::::
::::::::::::::::::::::::::::::::::::::::::::::::                           #::::
::::::::::::::::::::::::::::::::::::::::::::::::                           #::::
::::::::::::::::::::::::::::::::::::::::::::::::                           #::::
::::::::::::::::::::::::::::::::::::::::::::::#                            #::::
::::::::::::::::::::::::::::::::::::::::::::::##                           #::::
:::::::::::::::::::::::::::::::::::::::::::::::#                           #::::
:::::::::::::::::::::::::::::::::::::::::::::::#                           #::::
:::::::::::::::::::::::::::::::::::::::::::::::#                           #::::
::::::::::::::::::::::::::::::::::::::::::::::#:                           #::::
::::::::::::::::::::::::::::::::::::::::::::::#                            #::::
:::::::::::::::::::::::::::::::::::::::::::::#:                            #::::
::::::::::::::::::::::::::::::::::::::::::::::::                       #####::::
::::::::::::::::::::::::::::::::::::::::::::::::#                     ::::::::::
::::::::::::::::::::::::::::::::::::::::::::::::#                     #:::::::::
::::::::::::::::::::::::::::::::::::::::::::::::#                     #:::::::::
::::::::::::::::::::::::::::::::::::::::::::::::#                     #:::::::::
::::::::::::::::::::::::::::::::::::::::::::::::#                     #:::::::::
:::::::::::::::::::::::::::::::::::::::::::::::#                      #:::::::::
:::::::::::::::::::::::::::::::::::::::::::::::#                      #:::::::::
:::::::::::::::::::::::::::::::::::::::::::::::#                      #:::::::::
:::::::::::::::::::::::::::::::::::::::::::::::#                      #:::::::::
::::::::::::::::::::::::::::::::::::::::::::                          #:::::::::
:::::::::::::::::::::::::::::::::::::::::::#                          #:::::::::
::::::::::::::::::::::::::::::::::::::::::::####                     :#:::::::::
:::::::::::::::::::::::::::::::::::::::::::::::#                 ######:::::::::
:::::::::::::::::::::::::::::::::::::::::::::::#                :#::::::::::::::
:::::::::::::::::::::::::::::::::::::::::::::::#                ##::::::::::::::
:::::::::::::::::::::::::::::::::::::::::::::::#                #:::::::::::::::
:::::::::::::::::::::::::::::::::::::::::::::::#                #:::::::::::::::
:::::::::::::::::::::::::::::::::::::::::::::::#                #:::::::::::::::
:::::::::::::::::::::::::::::::::::::::::::::::#:               #:::::::::::::::
:::::::::::::::::::::::::::::::::::::::::::::::#:               #:::::::::::::::
::::::::::::::::::::::::::::::::::::::::::::::::#               #:::::::::::::::
::::::::::::::::::::::::::::::::::::::::::::::::#               #:::::::::::::::
::::::::::::::::::::::::::::::::::::::::::::::::::              #:::::::::::::::
::::::::::::::::::::::::::::::::::::::::::::::::::::            #:::::::::::::::
:::::::::::::::::::::::::::::::::::::::::::::::::::::##         #:::::::::::::::
::::::::::::::::::::::::::::::::::::::::::::::::::::::###########:::::::::::::::
