::::::::::::::::::::::::::::::::::::::::::::::::::::::::::::::::#:::::::::::::::
::::::::::::::::::::::::::::::::::::::::::::::::::::::::::::::::#::   ::::::::::
::::::::::::::::::::::::::::::::::::::::::::::::::::::::::::::::#        :::   #
::::::::::::::::::::::::::::::::::::::::::::::::::::::::::::::::#    :         #
::::::::::::::::::::::::::::::::::::::::::::::::::::::::::::::::#              #
::::::::::::::::::::::::::::::::::::::::::::::::::::::::::::::::#:             #
::::::::::::::::::::::::::::::::::::::::::::::::::::::::::::::::#            : #
::::::::::::::::::::::::::::::::::::::::::::::::::::::::::::::::#            : #
::::::::::::::::::::::::::::::::::::::::::::::::::::::::::::::::#              #
::::::::::::::::::::::::::::::::::::::::::::::::::::::::::::::::#              #
::::::::::::::::::::::::::::::::::::::::::::::::::::::::::::::::#             :#
::::::::::::::::::::::::::::::::::::::::::::::::::::::::::::::::#              #
::::::::::::::::::::::::::::::::::::::::::::::::::::::::::::::###       X      #
:::::::::::::::::::::::::::::::::::::::::::::::::::::::::::::#:         x      #
:::::::::::::::::::::::::::::::::::::::::::::::::::::::::::::           x      #
::::::::::::::::::::::::::::::::::::::::::::::::::::::::::::#####       x      #
::::::::::::::::::::::::::::::::::::::::::::::::::::::::::::::::#       x      #
::::::::::::::::::::::::::::::::::::::::::::::::::::::::::::::::#       x      #
::::::::::::::::::::::::::::::::::::::::::::::::::::::::::::::::#       x      #
::::::::::::::::::::::::::::::::::::::::::::::::::::::::::::::::#       x      #
::::::::::::::::::::::::::::::::::::::::::::::::::::::::::::::::#       x      #
::::::::::::::::::::::::::::::::::::::::::::::::::::::::::::::::#       x      #
::::::::::::::::::::::::::::::::::::::::::::::::::::::::::::::::#       x      #
::::::::::::::::::::::::::::::::::::::::::::::::::::::::::::::::#       x      #
::::::::::::::::::::::::::::::::::::::::::::::::::::::::::::::::#       x      #
::::::::::#:::::::::::::::::::::::::::::::::::::::::::::::::::::#       x      #
::::::::::#:::::::::::::::::::::::::::::::::::::::::::::::::::::#       x      #
::::::::::: :::#::::::::::::::::::::::::::::::::#:::::::::::::::#       x      #
::::::::::# ::::::::::::::::::::::::::::::::::::# ::::::::#::::##       x      #
::::::::::: ::::::::::::::::::::::::::::::::::::: ::::::: ::::::#       x      #
::::::::::# :::#::::::::::::::::::::::::::::::::# ::::::: :#::::#       x      #
#:::::::::#  :::#:::::::::::::::::::::::::::::::# ::::::   :::::#       x      #
# :::::::##  :: :::::::::::::::::::::::::::::::##  ::::    :::::#       x      #
#  :::::::   :  ::::::::::::::::::::::::::::::::   ::::   :#::::#       X      #
#   ::::::   : ::::::::::::::::::::::::::::::::::   ::   : :::::#      x       #
#   ::::::     #::::::::::::::::::::::::::::::::#    :    :#::::#     x        #
#    ::::#     #::::::::::::::::::::::::::::::::#:         #::::#    x         #
#     :::#     ##:::::::::::::#:::::::::::::::::#          #::::#   x          #
#    :::##     :#:::::::::::::#:::::::::::::::::#         :#::::#  x           #
#              :::::::::::::# #:::::::::::::::::#         :##:::# x            #
#              :::::::::::::: ##::#::      :::::#           #:::#x         #####
#              :#::::::::::::  :::#::         ::#           ##::x          #::::
#                :##########  #::::     :   ::  #    XxxxxxxxxxX           #::::
#                             #:::#::  ::: :  ::#   x                      #::::
#                             #::::: : :::  :  :#  x                       #::::
#                             #::::  : ::::  :  # x                        #::::
#                             ::#:  : ::::#: ###:x                         #::::
#                             :::###########:::xX                          #::::
#                                           Xxx                            #::::
#                                          x####                           #::::
#                                         X#::: #                          #::::
#                                         x#::::                           #::::
#                                         x#::::           :               #::::
#                     ##                  x#::::           :           #####::::
#             :####:::#:#                 x#::::          ::         :#:::::::::
#             #:::::::::#                 x#:::::                    :#:::::::::
#             :#::::::::#                 x#:::::                    :#:::::::::
#             :#::::::::#                 x##:::#                    :::::::::::
#             ##::::::::#                 x:::::#                    :#:::::::::
#              ::::::::##                 x:#:::#                    :#:::::::::
#             #::::::::::                 x:#:::#                    ##:::::::::
#             ##:::::::::                 X:::::#                    #::::::::::
#             ##::::::::#                x :#:::#                    ##:::::::::
#             ::::::::::#               x  :::::#                    #::::::::::
#              #::::::::#              x   ##:::#                    ##:::::::::
#              #::::::::#             x    :#:::#                    ##:::::::::
#             :#::::::::#            x     :::::#                 :###::::::::::
#             ::::::::::#           x      :#:::#               ####::::::::::::
#             #:::::::::#          x       :#:::#               #:::::::::::::::
#             ##::::::::#         x         #::##               #:::::::::::::::
#              :::::::::#        x         :#:::#               #:::::::::::::::
#              #::::::::#       x          :#:::#               #:::::::::::::::
#              #::::::::#      x           :#:::#               #:::::::::::::::
#              :::::::::#     x            :::::#               #:::::::::::::::
#              #::::::::#    X              ####                #:::::::::::::::
#              :::::::::#                   :::                 #:::::::::::::::
#             ##::::::::#                                       #:::::::::::::::
#             #:::::::::#                                       #:::::::::::::::
#             #:::::::::#                                       #:::::::::::::::
###############::::::::##########################################:::::::::::::::
