::::::::::::::::::::::::::::::::::::::::::::::::#########:::::::###:::::::::::::
:::::::::::::::::::::::::::::::::::::::::::::::::::::: :::::::::#:     ::::::  :
::::::::::::::::::::::::::::::::::::::::::::::  : : ::    ::#:::#              #
::::::::::::::::::::::::::::::::::::::::::::    :           ::::#              #
::::::::::::::::::::::::::::::::::::::::::::    :           ::::#              #
:::::::::::::::::::::::::::::::::::::::::::::   :          :#:::#:             #
:::::::::::::::::::::::::::::::::::::::::::::               ::::#              #
::::::::::::::::::::::::::::::::::::::::::::::             :#:::#              #
::::::::::::::::::::::::::::::::::::::::::::::             ##:::#              #
::::::::::::::::::::::::::::::::::::::::::::::              ::::#              #
:::::::::::::::::::::::::::::::::::::::::::::::            #::::#              #
:::::::::::::::::::::::::::::::::::::::::::::::            #::::#              #
:::::::::::::::::::::::::::::::::::::::::::::::#           #::::#              #
:::::::::::::::::::::::::::::::::::::::::::::::#           #::::#              #
:::::::::::::::::::::::::::::::::::::::::::::::#           #::::#              #
:::::::::::::::::::::::::::::::::::::::::::::::#           #::::#              #
:::::::::::::::::::::::::::::::::::::::::::::::#           #::::#              #
:::::::::::::::::::::::::::::::::::::::::::::::#           #::::#              #
:::::::::::::::::::::::::::::::::::::::::::::::#           #::::#              #
:::::::::::::::::::::::::::::::::::::::::::::::#           #::::#              #
:::::::::::::::::::::::::::::::::::::::::::::::#           #::::#              #
:::::::::::::::::::::::::::::::     :  ::::::::            #::::#              #
:::::::::::::::::::::::::# :               ::::            ##:::#              #
:::::::::::::::::::::::::#                 #::#            :#:::#              #
:::::::::::::::::::::::::#                 ::::            :#:::#              #
:::::::::::::::::::::::::#                 ::::            :#:::#              #
:::::::::::::::::::::::::#                 #::#            :#:::#              #
::::::::::::::::::::::::##                 #:::            :#:::#              #
:::::::::::::::::::::::::                  ::::             #:::#              #
:::::::::::::::::::::::::                  #::#             #:::#              #
:::::::::::::::::::::::::#                 ::::#            #:::#              #
::::::::::::::::::::::::##                 #:::#            #:::#              #
:::::::::::::::::::::::::                  #:::#            #:::#              #
:::::::::::::::::::::::::#                 #:::#            #:::#              #
:::::::::::::::::::::::::#                 #:::#            #:::#              #
:::::::::::::::::::::::::#                 ::::#           :##::#              #
::::::::::::::::::::::::##                 ::               #:::#              #
::::::::::::::::::::::::#                                   #:##               #
::::::::::::::::::::::::####   :#::::::                       #                #
:::::::::::::::::::::::::::#   ::::::                                          #
::::::::::::::::::::::::::::  :::::::::::::::::#                           #####
::::::::::::::::::::::::::::   ::::::::::::::::                            #::::
:::::::::::::::::::::::::::#   ::::::::::::::::                            #::::
::::::::::::::::::::::::::::   :::::::::::::::#                            #::::
::::::::::::::::::::::::::::   ::::::::::::::::                            #::::
:::::::::::::::::::::::::::    :::::::::::::::#                            #::::
:::::::::::::::::::::::::::    ::::::::::::::::                            #::::
:::::::::::::::::::::::::::    :::::::::::::::#                            #::::
::::::::::::::::::::::::::     ::::::::::::::::                            #::::
::::::::::::::::::::::::::     :::::::::::::::#                            #::::
::::::::::::::::::::::::::     ::::::::::::::::                            #::::
::::::::::::::::::::::::::     ::::::::::::::#:                            #::::
::::::::::::::::::::::::::     :::::::::::::::                             #::::
:::::::::::::::::::::::::::::::::::::::::::::#:                       ######::::
:::::::::::::::::::::::::::::::::::::::::::::::                       #:::::::::
::::::::::::::::::::::::::::::::::::::::::::::#                       #:::::::::
::::::::::::::::::::::::::::::::::::::::::::::#                       #:::::::::
::::::::::::::::::::::::::::::::::::::::::::::#                       #:::::::::
:::::::::::::::::::::::::::::::::::::::::::::::                       #:::::::::
::::::::::::::::::::::::::::::::::::::::::::::                        #:::::::::
:::::::::::::::::::::::::::::::::::::::::::::::                      :#:::::::::
:::::::::::::::::::::::::::::::::::::::::::::::                    :::::::::::::
::::::::::::::::::::::::::::::::::::::::::::::#                  :::::::::::::::
::::::::::::::::::::::::::::::::::::::::::::::::#               ::::::::::::::::
:::::::::::::::::::::::::::::::::::::::::::::::::           ::::::::::::::::::::
::::::::::::::::::::::::::::::::::::::::::::::::: :  : :::::::::::::::::::::::::
::::::::::::::::::::::::::::::::::::::::::::::::::::::::::::::::::::::::::::::::
::::::::::::::::::::::::::::::::::::::::::::::::::::::::::::::::::::::::::::::::
::::::::::::::::::::::::::::::::::::::::::::::::::::::::::::::::::::::::::::::::
::::::::::::::::::::::::::::::::::::::::::::::::::::::::::::::::::::::::::::::::
::::::::::::::::::::::::::::::::::::::::::::::::::::::::::::::::::::::::::::::::
::::::::::::::::::::::::::::::::::::::::::::::::::::::::::::::::::::::::::::::::
::::::::::::::::::::::::::::::::::::::::::::::::::::::::::::::::::::::::::::::::
::::::::::::::::::::::::::::::::::::::::::::::::::::::::::::::::::::::::::::::::
::::::::::::::::::::::::::::::::::::::::::::::::::::::::::::::::::::::::::::::::
::::::::::::::::::::::::::::::::::::::::::::::::::::::::::::::::::::::::::::::::
::::::::::::::::::::::::::::::::::::::::::::::::::::::::::::::::::::::::::::::::
::::::::::::::::::::::::::::::::::::::::::::::::::::::::::::::::::::::::::::::::
::::::::::::::::::::::::::::::::::::::::::::::::::::::::::::::::::::::::::::::::
::::::::::::::::::::::::::::::::::::::::::::::::::::::::::::::::::::::::::::::::
