::::::::::::::::::::::::::::::::::::::::::::::::::::::::::::::::::::::::::::::::
:###########::::::::::::::::::::::::::::::::::::::::::::::::::::::::::::::::::::
:#          ::::::::::::::::::::::::::::::::::::::::::::::::::::::::::::::::::::
:#         :::::::::::::::::::::::::::::::::::::::::::::::::::::::::::::::::::::
:#         :::::::::::::::::::::::::::::::::::::::::::::::::::::::::::::::::::::
:#         :::::::::::::::::::::::::::::::::::::::::::::::::::::::::::::::::::::
:#        ::::::::::::::::::::::::::::::::::::::::::::::::::::::::::::::::::::::
:#        ::::::::::::::::::::::::::::::::::::::::::::::::::::::::::::::::::::::
:#        ::::::::::::::::::::::::::::::::::::::::::::::::::::::::::::::::::::::
:#       :::::::::::::::::::::::::::::::::::::::::::::::::::::::::::::::::::::::
:#      #:::::::::::::::::::::::::::::::::::::::::::::::::::::::::::::::::::::::
:#      #:::::::::::::::::::::::::::::::::::::::::::::::::::::::::::::::::::::::
:#      #:::::::::::::::::::::::::::::::::::::::::::::::::::::::::::::::::::::::
:#      #:::::::::::::::::::::::::::::::::::::::::::::::::::::::::::::::::::::::
:#      #:::::::::::::::::::::::::::::::::::::::::::::::::::::::::::::::::::::::
:#      #:::::::::::::::::::::::::::::::::::::::::::::::::::::::::::::::::::::::
:#      #:::::::::::::::::::::::::::::::::::::::::::::::::::::::::::::::::::::::
:#      #:::::::::::::::::::::::::::::::::::::::::::::::::::::::::::::::::::::::
:#      #:::::::::::::::::::::::::::::::::::::::::::::::::::::::::::::::::::::::
:#      #:::::::::::::::::::::::::::::::::::::::::::::::::::::::::::::::::::::::
:#      #:::::::::::::::::::::::::::::::::::::::::::::::::::::::::::::::::::::::
:#      #:::::::::::::::::::::::::::::::::::::::::::::::::::::::::::::::::::::::
:#      #:::::::::::::::::::::::::::::::::::::::::::::::::::::::::::::::::::::::
:#      #:::::::::::::::::::::::::::::::::::::::::::::::::::::::::::::::::::::::
:#      #:::::::::::::::::::::::::::::::::::::::::::::::::::::::::::::::::::::::
:#      #:::::::::::::::::::::::::::::::::::::::::::::::::::::::::::::::::::::::
:#      #:::::::::::::::::::::::::::::::::::::::::::::::::::::::::::::::::::::::
:#      #:::::::::::::::::::::::::::::::::::::::::::::::::::::::::::::::::::::::
:#      #::::::::::#::::::::::::::::::::::::::::::::::::::::::::::::::::::::::::
:#      #::::::::: #::::::::::::::::::::::::::::::::::::::::::::::::::::::::::::
:#      #::::::::  #::::::::::::::::::::::::::::::::::::::::::::::::::::::::::::
:#      #::::::::  #::::::::::::::::::::::::::::::::::::::::::::::::::::::::::::
:#      #:::::::   #::::::::::::::::::::#:::::::::::::::::::::::::::::::::::::::
:#      #:::::::   #::::::::::::::::::  ####::::::::::::::::::::::::::::::::::::
:#      #::::::    #::::::::::::::::    ####::::::::::::::::::::::::::::::::::::
:#      #:::::     #::::::::::::::         :::::::::::::::::::::::::::::::::::::
:#      #::::      #::::::::::::         :::::::::::::::::::::::::::::::::::::::
:#      ######     #:::::::::          :::::::::::::::::::::::::::::::::::::::::
:#                 ##########        ::::::::  #::::::::::::::::::::::::::::::::
:#                                ::::::       #::::::::::::::::::::::::::::::::
:#                                             #::::::::::::::::::::::::::::::::
:#                                             #::::::::::::::::::::::::::::::::
:#                                             #::::::::::::::::::::::::::::::::
:#                   ######                    #::::::::::::::::::::::::::::::::
:#                   #::::::::                 #::::::::::::::::::::::::::::::::
:#                   #:::::::::::::            #::::::::::::::::::::::::::::::::
:#                   #::::::::::::::::::       #::::::::::::::::::::::::::::::::
:#                   #::::::::::::::::::::::   #::::::::::::::::::::::::::::::::
:#                   #::::::::::::::::::::::::::::::::::::::::::::::::::::::::::
:#                   #::::::::::::::::::::::::::::::::::::::::::::::::::::::::::
:#                   #::::::::::::::::::::::::::::::::::::::::::::::::::::::::::
:#                   #::::::::::::::::::::::::::::::::::::::::::::::::::::::::::
:#                   #::::::::::::::::::::::::::::::::::::::::::::::::::::::::::
:#                   #::::::::::::::::::::::::::::::::::::::::::::::::::::::::::
:#                   #::::::::::::::::::::::::::::::::::::::::::::::::::::::::::
:#    ###########    #::::::::::::::::::::::::::::::::::::::::::::::::::::::::::
:#     :::::::::     #::::::::::::::::::::::::::::::::::::::::::::::::::::::::::
:#     ::::::::::       ::::::::::::::::::::::::::::::::::::::::::::::::::::::::
:#     ::::::::::          :::::::::::::::::::::::::::::::::::::::::::::::::::::
:#     :::::::::::           :::::::::::::::::::::::::::::::::::::::::::::::::::
:##### ::::::::::::             ::::::::::::::::::::::::::::::::::::::::::::::::
:#     :::::::::::: #######      :::::::::::::::::::::::::::::::::::::::::::::::
:#    :::::::::::::                 ::::::::::::::::::::::::::::::::::::::::::::
:#    ::::::::::::::                  ::::::::::::::::::::::::::::::::::::::::::
:#    ::::::::::::::###############      :::::::::::::::::::::::::::::::::::::::
:#    ::::::::::::::::::::::::::::::      ::::::::::::::::::::::::::::::::::::::
:#    :::::::::::::::::::::::::::::::::     ::::::::::::::::::::::::::::::::::::
:#    ::::::::::::::::::::::::::::::::::      ::::::::::::::::::::::::::::::::::
:#    ::::::::::::::::::::::::::::::::::: ######::::::::::::::::::::::::::::::::
:#    ::::::::::::::::::::::::::::::::::::::::::::::::::::::::::::::::::::::::::
:#   :::::::::::::::::::::::::::::::::::::::::::::::::::::::::::::::::::::::::::
:#   :::::::::::::::::::::::::::::::::::::::::::::::::::::::::::::::::::::::::::
:#   :::::::::::::::::::::::::::::::::::::::::::::::::::::::::::::::::::::::::::
:#   :::::::::::::::::::::::::::::::::::::::::::::::::::::::::::::::::::::::::::
:#   :::::::::::::::::::::::::::::::::::::::::::::::::::::::::::::::::::::::::::
:#   :::::::::::::::::::::::::::::::::::::::::::::::::::::::::::::::::::::::::::
:#   :::::::::::::::::::::::::::::::::::::::::::::::::::::::::::::::::::::::::::
:#   :::::::::::::::::::::::::::::::::::::::::::::::::::::::::::::::::::::::::::
:#  ::::::::::::::::::::::::::::::::::::::::::::::::::::::::::::::::::::::::::::
:###::::::::::::::::::::::::::::::::::::::::::::::::::::::::::::::::::::::::::::
