:::::::::::::::::::::::::::::::::::::::::::##:##########::::::::##::::::::::::::
:::::::::::::::::::::::::::::::::::::::::::   :   ::   :::::::::##     :::::   :
::::::::::::::::::::::::::::::::::::::: ::        ::       #::::#:             #
:::::::::::::::::::::::::::::::::::::::  :         :       #::::#              #
::::::::::::::::::::::::::::::::::::::::  :        :        #:::#:             #
:::::::::::::::::::::::::::::::::::::::::                   #:::#              #
::::::::::::::::::::::::::::::::::::::::::                  #:::#:             #
::::::::::::::::::::::::::::::::::::  :::::                 #:::#              #
::::::::::::::::::::::::::::::::::::::  ::::               :#:::#              #
::::::::::::::::::::::::::::::::::::::::   ::              :#:::#              #
:::::::::::::::::::::::::::::::::::::::::::  :              #:::#             :#
::::::::::::::::::::::::::::::::::::::::::::::             ##:::#              :
:::::::::::::::::::::::::::::::::::::::::::::::#           :#:::#       X      #
:::::::::::::::::::::::::::::::::::::::::::::::#           ##:::#       x      #
:::::::::::::::::::::::::::::::::::::::::::::::#           :#:::#       x      #
:::::::::::::::::::::::::::::::::::::::::::::::#:           #:::#       x      #
:::::::::::::::::::::::::::::::::::::::::::::::#:           #:::#       x      #
:::::::::::::::::::::::::::::::::::::::::::::::#            #:::#       x      #
:::::::::::::::::::::::::::::::::::::::::::::::#:          :#:::#       x      #
:::::::::::::::::::::::::::::::::::::::::::::::#           :#:::#       x      #
:::::::::::::::::::::::::::::::::::::::::::::::#           :#:::#       x      #
:::::::::::::::::::::::::::::::::::::::::::::::#           :#:::#       x      #
:::::::::::::::::::::::::::::::::::::::::::::::#            ::::#       x      #
:::::::::::::::::::::::::::::::::::::::::::::::#           ##:::#       x      #
:::::::::::::::::::::::::::::::::::::::::::::::#            ::::#       x      #
:::::::::::::::::::::::::::::::::::::::::::::::#            #:::#       x      #
:::::::::::::::::::::::::::::::::::::::::::::::             ::::#       x      #
:::::::::::::::::::::::::::::::::::::::::::::::            ##:::#       x      #
:::::::::::::::::::::::::::::::::::::::::::::::            #::::#       x      #
:::::::::::::::::::::::::::::::::::::::::::::::            #::::#       x      #
::::::::::::::::::::::::::::::::::::::::::::::##           ##:::#       x      #
:::::::::::::::::::::::::::::::::::::::::::::::#:          #::::#       x      #
:::::::::::::::::::::::::::::::::::::::::::::::#            ::::#       x      #
:::::::::::::::::::::::::::::::::::::::::::::::#            #:::#       x      #
:::::::::::::::::::::::::::::::::::::::::::::::#            #:::#       x      #
:::::::::::::::::::::::::::::::::::::::::::::::#            #:::#       x      #
:::::::::::::::::::::::::::::::::::::::::::::::             #:::#       x      #
::::::::::::::::::::::::::::::::::::::     #####            ###:        x      #
::::::::::::::::::::::::::::::::::::::::                                x      #
::::::::::::::::::::::::::::::::::::::::::::::                          x      #
:::::::::::::::::::::::::::::::::::::::::::::::#                        X  #   #
:::::::::::::::::::::::::::::::::::::::::::::::#                       x   #:::#
:::::::::::::::::::::::::::::::::::::::::::::::#                      x    #::::
:::::::::::::::::::::::::::::::::::::::::::::::#                     x     #::::
:::::::::::::::::::::::::::::::::::::::::::::::#                    x      #::::
:::::::::::::::::::::::::::::::::::::::::::::::#                   x       #::::
:::::::::::::::::::::::::::::::::::::::::::::::#                  x        #::::
:::::::::::::::::::::::::::::::::::::::::::::::#                 x         #::::
:::::::::::::::::::::::::::::::::::::::::::::::#                x          #::::
:::::::::::::::::::::::::::::::::::::::::::::::#               x           #::::
:::::::::::::::::::::::::::::::::::::::::::::::#              x            #::::
:::::::::::::::::::::::::::::::::::::::::::::###             x             #::::
:::::::::::::::::::::::::::::::::::::::::::::::#            x              #::::
:::::::::::::::::::::::::::::::::::::::::::::::#           x          ######::::
:::::::::::::::::::::::::::::::::::::::::::::::#          x           #:::::::::
:::::::::::::::::::::::::::::::::::::::::::::::#         x            #:::::::::
:::::::::::::::::::::::::::::::::::::::::::::::#        x             #:::::::::
:::::::::::::::::::::::::::::::::::::::::::::::#       x              #:::::::::
:::::::::::::::::::::::::::::::::::::::::::::::#      x               #:::::::::
:::::::::::::::::::::::::::::::::::::::::::::::#     x                #:::::::::
:::::::::::::::::::::::::::::::::::::::::::::::#    x                 #:::::::::
:::::::::::::::::::::::::::::::::::::::::::::::#   x                : #:::::::::
::::::::::::::::::::::::::::::::    :::::::::::#  x                  :::::::::::
:::::::::::::::::::::::::::::::::       :::::::# x                 :::::::::::::
:::::::::::::::::::::::::::::::::            ##:x               ::::::::::::::::
::::::::::::::::::::::::::::::::              xX                #:::::::::::::::
:::::::::::::::::::::::::::::::::            X #                #:::::::::::::::
:::::::::::::::::::::::::::::::::::::::::##::::#                #:::::::::::::::
:::::::::::::::::::::::::::::::::::::::::::::::#               :::::::::::::::::
:::::::::::::::::::::::::::::::::::::::::::::::#               :::::::::::::::::
::::::::::::::::::::::::::::::::::::::::::::::::              ::::::::::::::::::
:::::::::::::::::::::::::::::::::::::::::::::::#              ::::::::::::::::::
:::::::::::::::::::::::::::::::::::::::::::::::#              ::::::::::::::::::
::::::::::::::::::::::::::::::::::::::::::::::::              ::::::::::::::::::
:::::::::::::::::::::::::::::::::::::::::::::::#              ::::::::::::::::::
::::::::::::::::::::::::::::::::::::::::::::::::             :::::::::::::::::::
:::::::::::::::::::::::::::::::::::::::::::::::#            ::::::::::::::::::::
:::::::::::::::::::::::::::::::::::::::::::::::#          ::::::::::::::::::::::
:::::::::::::::::::::::::::::::::::::::::::::::::        :::::::::::::::::::::::
:::::::::::::::::::::::::::::::::::::::::::::::#########::::::::::::::::::::::::
