:::::::::::::::::::#################::::::::::::::::::::::::::::#:::::::::::::::
::::::::::::::::::::   :: :    :   :::::::::::::::::::::::::::::#     ::::::::::
:::::::::::::::::::::     :        :::::::::::::::::::::::::::::#         :::  #
:::::::::::::::::::::     :        :::::::::::::::::::::::::::::#:             #
::::::::::::::::::::::            ::::::::::::::::::::::::::::::#:             #
::::::::::::::::::::::            ::::::::::::::::::::::::::::::#              #
::::::::::::::::::::::           ::::::::::#::::#:::::::::::::::#            ::#
:::::::::::::::::::::::          ::::::::: #::::#  :::::::::::::#            ::#
:::::::::::::::::::::::         ::::::::   #::::#   ::::::::::::#              :
:::::::::::::::::::::::         ::::::     #::::#    :::::::::::#             :#
::::::::::::::::::::::::       :::::       #::::#      :::::::::#              #
::::::::::::::::::::::::       :::         #::::#       ::::::::#              #
:::::#::::::::::::::#:::                   #::::#         ::::::#              #
:::: #::::::::::::::#     ::               #::::#           ###:               #
#::: :::::::::::::::#     :                #::::#                       :      #
#::: #::::::::::::::#     :                #::::#           #####      :       #
# : :#::::::::::::::#     :                #::::#          #::::#              #
# : :#::::::::::::::#     :                #::::#          #::::#           :  #
#    #::::::::::::::#                      #::::#          #::::#           :  #
#    #::::::::::::::#                      #::::#          #::::#           :: #
#    #::::::::::::::#                      #::::#          #::::#          ::: #
#    #::::::::::::::#                     :#::::#          #::::#         :::::#
#    #::::::::::::::#              :       #::::#          #::::#         :::::#
#    #::::::::::::::#             ::       #::::#          #::::#          :::::
#    #::::::::::::::# #          ::::      #:::##          ##:::#          :::::
#    ##:#::::::::::::::##:      ::::::     #::::            ::::#            :::
#    ::::::::::::::::::::#     ::::::::    #::::           ##:::#              #
#    ::::::::::::::::::::#    ::::::::::   #:::#            ::::#              #
#    :#::::::::::::::::::#    ::::::::::   #:::#           ##:::#              #
#    :::::#::::::::::::::#   ::::::::::::  #:::#            #:::#              #
#     ::::# :::#:::::::::#   ::::::::::::: #:::#           :#:::#              #
#     #:::# ::###::::::::#   ::::::::::::::##:##:          :#:::#              #
#     #:::# : # :::::::::#    ::::::::::::::#              :::::#              #
#     #:::#    ::::::::::#    :#:::::::::::#:              #::::#              #
#     #:::#    :#::::::::#    :::::::::::::::#  :          #::::#              #
#     #:::#    ::::::::::#     :::::::::::::::::           #::::#              #
#     #:::#     #::::::::#           ::::::#:::#:          #::::#              #
#     ####     ::::::::::##::  :: #::::::#::::::           #::::#              #
#     ::::     #::::::::::::   #::#::::::::::::##          #::::#              #
#              #::::::::::::: ##:::::::::::::::##          #::::#              #
#              #::::::::::#:# ##:::::::::::::::#           #::#:#          #####
#              :#:#::#####:#  ##:::::::::::::::#           #::###          #::::
#                ##      ##   ##:::::::::::::::#                           #::::
#                             ##:::::::::::::::#              ::::         #::::
#                              #:::::::::::::::#:           ::::::::::     #::::
#              :               #::::::::::::::::#           ::::::::::     #::::
#              :               #:::::#:::::::##:         :: ::::::::::     #::::
#                              :######:::::###          ::::#::::::::      #::::
#                                                     :::::::::::::::      #::::
#                                          ####      ::::::::::::::::      #::::
#                                          :::#::    ::::::::::::::::      #::::
#                                          #::::#    :::::::::::::::       #::::
#                                   :      #::::#    :::::::::::::::       #::::
#             ######## :            :      #::::#    ::::::::::::::   ######::::
#             #:::::##:#                   #::::#    :::::::::::::    #:::::::::
#             #::::::::##                  #::::#   ::::::::::::::    #:::::::::
#             ##::::::::#                  #:::##   ::::::::::::::    #:::::::::
#             ::::::::::#                  #:::::   :::::::::::::     #:::::::::
#             #:::::::::#                  #:::#:   :::::::::::::    :#:::::::::
#             #:::::::::#                  #:::::   :::::::::::::    :#:::::::::
#             #:::::::::#                  #:::#:   :::::::::::::    :#:::::::::
#   :         #:::::::::#                  #:::#:   :::::::::::::    :::::::::::
#             #:::::::::#                  ##::#:   :::::::::::::    #::::::::::
#             #:::::::::#                  ::::::    ::::::::::::    #::::::::::
#             #:::::::::#                  :::::#       :::::::      ##:::::::::
#             #:::::::::#                  :::::#                     #:::::::::
#             #:::::::::#                  :::::#                ######:::::::::
#             #:::::::::#                  :::::#               :#::::::::::::::
#             #:::::::::#                  :::::#               :#::::::::::::::
#             #:::::::::#                  :#:::#               :#::::::::::::::
#             ##::::::::#                  :#:::#               :#::::::::::::::
#              :::::::::#                  :#:::#               :#::::::::::::::
#              #::::::::#                   #:::#               ::::::::::::::::
#             ##::::::::#                   :::::               :#::::::::::::::
#              :::::::::#                   ####                ::::::::::::::::
#       :      #::::::::#    :::            #                   ::::::::::::::::
#       :      #::::::::#   ::                                  ##::::::::::::::
#     : :    : :::::::::#::::                                    #::::::::::::::
#  :  : : :  ::#:::::::::::                                      #::::::::::::::
##############::::::::::::########################################::::::::::::::
