::::::::::::::::::::::::::::::::::::::::###:################::::#:::::::::::::::
:::::::::::::::::::::::::::::::::::::::::                  #::::#:    ::::::::::
:::::::::::::::::::::::::::::::::::::::::::                #::::#         ::   #
::::::::::::::::::::::::::::::::::::::::::::               ##:::#              #
:::::::::::::::::::::::::::::::::::::::::::::              :::::#              #
::::::::::::::::::::::::::::::::::::::::::::::             ##:::#::            #
::::::::::::::::::::::::::::::::::::::::::::::::           :::::#            : #
::::::::::::::::::::::::::::::::::::::::::::::::           :::::#            : #
:::::::::::::::::::::::::::::::::::::::::::::::::          ##:::#              #
::::::::::::::::::::::::::::::::::::::::::::::::#          :::::#              #
::::::::::::::::::::::::::::::::::::::::::::::::#          :::::#              #
::::::::::::::::::::::::::::::::::::::::::::::::#          #::::#              #
::::::::::::::::::::::::::::::::::::::::::::::::           #:::#:XxxxxxxX      #
::::::::::::::::::::::::::::::::::::::::::::::::             #::x              #
:::::::::::::::::::::::::::::::::::::::::::::::#            XxxX               #
::::::::::::::::::::::::::::::::::::::::::::::::           x  ###              #
:::::::::::::::::::::::::::::::::::::::::::::::##         X:###:#              #
:::::::::::::::#::::::::::::::::::::::::::::::::#         x#::::#              #
::::::::::#:::::::::::::::::::::::::::::::::::::#         x #:::#              #
::::::::::::::::::::::::::::::::::::::::::::::::#         x:#:::#              #
:::::::::::::: #::::::::::::::::::::::::::::::::          x##:::#              #
:::::::::::::: :::::::::::::::::::::::::::::::::          x:#:::#              #
::::::::::#::: :#:::::::::::::::::::::::::::::::          x:::::#              #
::::::::::: ::  ::::::::::::::::::::::::::::::::          x:::::#              #
::::::::::# :   ::::::::::::::::::::::::::::::::          x##:::#              #
::::::::::# :   :::::::::::::::::::::::::::::::#          x:::::#              #
::::::::::# :  #:::::::::::::::::::::::::::::::#          x:::::#              #
::::::::::# :  #:::::::::::::::::::::::::::::::##         x:::::#              #
::::::::::#    #::::::::::::::::::::::::::::::::#         x:::::#              #
::::::::::#    #::::::::::::::::::::::::::::::::#         x:#:::#              #
::::::::::#    #::::::::::::::::::::::::::::::::          x:#:::#              #
::::::::::#    #::::::::::::::::::::::::::::::::          x:::::#              #
::::::::::#    #:::::::::::::::::::::::::::::##           x:#:::#              #
::::::::::#X   #::::::::::::::::::::::::::::              x:#:::#              #
::::::::::# x  #:::::::::::::::::::::::::::#####          x:#:::#              #
#:::::::::#  x #:::::::::::::::::::::::::::::::##         x:::::#              #
#:  ::::::#   X#::::::::::::::::::::::::::::::::          x:::::#              #
#     :#::#   x#:#::::::::::::::::::::::::::::::          X:::::#              #
#      #:#    x#::  ::::::::#:#:::::::::::::::::         x ##:::#              #
#             x#:::   ::::::::#::::::::::::::::#        x  :#:::#              #
#             x#:::::  :::::# #:::::::::::::::::       x   :#:::#             ##
#:            X:#:::::  ::::# #:::::::::::::::::      x                    #####
#              xx :#########  #:::::::::::::::::     x                     #::::
#                XxxxxxxxxxX  :::::::::::::::::##   x                      #::::
#                           x ::::::::::::::::::#  x                       #::::
#             ::             x :::::::::::::::::# x                       :#::::
#   :        :::              x#::::::::#::#:::: x                         #::::
#:         :::::               x  ############::x                          #::::
#         ::::::                XxxxxxxxxxxxxxxX                           #::::
#     :  :::::::                           :##                            :#::::
#:     :::::::::                           :::::#                         :#::::
:  :  ::::::::::                           #::::#                          #::::
#::  :::::::::::                           #::::#                         :#::::
:   :::::::::::##########          #       #::::#                       ##:#::::
: ::::::::::::::::::::::#         ::       #::::#                    #:::::#::::
#:::::::::::::::::::::::#        ::: ::    #::::#                    :::::::::::
::::::::::::::::::::::::#       ::::  :    #::::#                    :::::::::::
::::::::::::::::::::::::#      :::: : :    #::::#                    :::::::::::
::::::::::::::::::::::::#     ::::: : :    #::::#                    ##:::::::::
::::::::::::::::::::::::#    :::::#:: ::   #::::#                    #::::::::::
::::::::::::::::::::::::#   ::::::::::#::  #::::#                    #::::::::::
::::::::::::::::::::::::   ::::::::::::::  #::::#                    #::::::::::
:::::::::::::::::::::::##  ::::::::::::::  #::::#                    #::::::::::
::::::::::::::::::::::::# ::::::::::::#::: #::::#            :       #::::::::::
::::::::::::::::::::::::#::::::::::::::::: :::::#          :::       #::::::::::
:::::::::::::::::::::::::::::::::::::::::: #::::#         ::::     ::#::::::::::
:::::::::::::::::::::::::::::::::::::::::::#::::#       ::::::  #####:::::::::::
::::::::::::::::::::::::::::::::::::::::::::::::#      :::::::  #:::::::::::::::
::::::::::::::::::::::::::::::::::::::::::::::::#    :::::::::  #:::::::::::::::
::::::::::::::::::::::::::::::::::::::::::::::::#   ::::::::::  #:::::::::::::::
::::::::::::::::::::::::::::::::::::::::::::::::# ::::::::::::  #:::::::::::::::
::::::::::::::::::::::::::::::::::::::::::::::::#:::::::::::::  #:::::::::::::::
::::::::::::::::::::::::::::::::::::::::::::::::::::::::::::::  #:::::::::::::::
:::::::::::::::::::::::::::::::::::::::::::::::::::::::::::::: :#:::::::::::::::
:::::::::::::::::::::::::::::::::::::::::::::::::::::::::::::: :::::::::::::::::
:::::::::::::::::::::::::::::::::::::::::::::::::::::::::::::: :::::::::::::::::
:::::::::::::::::::::::::::::::::::::::::::::::::::::::::::::: :::::::::::::::::
:::::::::::::::::::::::::::::::::::::::::::::::::::::::::::::: :::::::::::::::::
:::::::::::::::::::::::::::::::::::::::::::::::::::::::::::::: :::::::::::::::::
:::::::::::::::::::::::::::::::::::::::::::::::::::::::::::::##:::::::::::::::::
