####################################################################################################################::::::::::::::::::::::::::::::::::::::::::::
##                                                                                                                        ::::::::::::::::::::::::::::::::    ::
##                                                                                                            ##::::::::::::::::::##::::::::::::::::::        ##
##                                                                                                            ::::::::::::::::::::##::::::                    ##
##                                                                                                            ::##::::::::::::::::##::::::::::                ##
##                                                                                                              ::::::::::::::::::##::                        ##
##                                                                                                            ####::::::::::::::::##                          ##
##          ::##::::::::::::::::                                                                              ::::::::::::::::::::##                          ##
##          ##::::::::::::::::##::                                                                      ::    ::##::::::::::::::::##                          ##
##          ##::::::::::::::::##::                                                                            ::##::::::::::::::::##                          ##
##        ::##::::::::::::::::##::                                                                              ::::::::::::::::::##                          ##
##          ##::::::::::::::::##::                                                                            ##::::::::::::::::::##                          ##
##          ##::::::::::::::::##::                                                                            ##::::::::::::::::::##                          ##
##          ##::::::::::::::::##                                                                              ##::::::::::::::::::##                          ##
##          ##::::::::::::::::##                                                                              ##::::::::::::::::::##                          ##
##          ##::::::::::::::::##                                            ::  ::::::                        ##::::::::::::::::::##                          ##
##        ::##::::::::::::::::##::                                        ####::::::::::::::::                ##::::::::::::::::::##                          ##
##          ##::::::::::::::::##::                                        ::::::::::::::::::##                ##::::::::::::::::::##                          ##
##          ##::::::::::::::::##::                                      ##::::::::::::::::##::                ##::::::::::::::::::##                          ##
##        ::::::::::::::::::::##                                        ##::::::::::::::::##                    ::::::::::::::::::##                          ##
##        ::::::::::::::::::::##::                                      ##::::::::::::::::##                  ####::::::::::::::::##                          ##
##        ::##::::::::::::::::##::                                      ##::::::::::::::::##::                ##::::::::::::::::::##                          ##
##        ::##::::::::::::::::##::                                      ##::::::::::::::::::                    ::::::::::::::::::##                          ##
##        ::::::::::::::::::::##::::::                                  ##::::::::::::::::##                  ####::::::::::::::::##                          ##
##        ##::::::::::::::::::##::                                      ##::::::::::::::::::                    ::::::::::::::::::##                          ##
##        ##::::::::::::::::::##::                                      ::##::::::::::::::::                    ::::::::::::::::::##                          ##
##        ##::::::::::::::::::##                                        ::::::::::::::::::##                    ::::::::::::::::::##                          ##
##        ##::::::::::::::::::##::                                      ::::::::::::::::::::                    ##::::::::::::::::##                          ##
##        ##::::::::::::::::::::::                                      ::########::::::::::                    ##::::::::::::::::##                          ##
##        ##::::::::::::::::::::::                                      ::::##::######::::::                    ::::::::::::::::::##                          ##
##        ##::::::::::::::::::::::                                                ::##::::::                    ::::::::::::::::::##                          ##
##        ##::::::::::::::::::::::                                                ::##::::::##                  ::::::::::::::::::##                          ##
##        ##::::::::::::::::::::                                                  ::##::::::##                  ::::::::::::::::::##                          ##
##        ##::::::::::::::::::::::                                                ::##::::::##                  ::::::::::::::::::##                          ##
##        ##::::::::::::::::::::::                                                ##::::::::##                  ##::::::::::::::::##                          ##
##        ##::::::::::::::::::::::::                                              ##::::::::##                  ##::::::::::::::::##                          ##
##        ##::::::::::::::::::::::::                                              ##::::::::##                  ##::::::::::::::::##                          ##
##        ##::::::::::::::::::::::::                                              ##::::::::##                  ::::::::::::::::::##                          ##
##        ##::::::::::::::::::::::                                                ##::::::::##                  ##::::::::::::::::##                          ##
##        ##::::::::::::::::::::::::                                              ##::::::::##                  ::::::::##::##::::::                          ##
##        ##::::::::::::::::::::::::::              ########::                      ::::::::##                  ######::::::::::::                            ##
##        ##::::::::::::::::::::::::::      ::::::::::::::##::                          ######                                                                ##
##        ##::::::::::::::::::::::::  ::::::::::::::::::::::::                                                                                                ##
##::      ##::::::::::::::::::::::::::::::::::::::::::::::##                                                                                                  ##
##::      ##::::::::::::::::::::::::::::::::::::::::::::::##                                                                                                  ##
##::      ##::::::::::::::::::::::::::::::::::::::::::::::::                                                                                                  ##
::::        ::::::::::::::::::::::::::::::::::::::::::::::::                                                                                                  ##
::::                                  ::::::::::::::::::##::                                                                                                  ##
::::                                  ::::::::::::::::::::::##                                                                                                ##
::                                  ::::::::::::::::::::::::                                                                                                  ##
::                                ::::::::::::::::::::::##::                                                                                                  ##
::                                    ::::::::::::::::::::::                              ::                                                        ::::      ##
::                                  ::::::::::::::::::::::                              ####::::::                                                  ########  ##
::::                                  ::::::::::::::::::::                              ::::::                                                      ##::::::::##
##::                                ::::::::::::::::::::::::                          ##::::::::##                                                  ##::::::::##
##::                                ::::::::::::::::::::::  ##                        ##::::::::##                                                  ##::::::::::
::::                                ::::::::::::::::::::::::##                        ##::::::::##                                                ::##::::::::::
::::                                ::::::::::::::::::::::::::                        ##::::::####                                                ::##::::::::::
::::                                ::::::::::::::::::::::::::                        ##::::::::::                                                ####::::::::::
::::                                ::::::::::::::::::::::::::                        ##::::::::##                                                ##::::::::::::
::::                                  ::::::::::::::::::::::::                        ##::::::::##                                                ##::::::::::::
::::                                ::::::::::::::::::::::::::                        ##::::::::##                                                ##::::::::::::
::::::                              ::::::::::::::::::::::####                        ##::::::::##                                                ##::::::::::::
::::::                              ::::::::::::::::::::::##::                        ::######  ::                                                ####::::::::::
::::::::                              ::::::::::::::::::::##::                                                                                  ::##::::::::::::
::::::::                        ::##::::::::::::::::::::::::::                                                                            ##    ####::::::::::::
::::::::                      ##::::::::::::::::::::::::::##::                                                                  ::::##::::::::::##::::::::::::::
::::::::                      ##::::::::::::::::::::::::::##::                                                                ::::::::::::::::::::::::::::::::::
::::::                          ::::::::::::::::::::::::::::::                                                                ::::::::::::::::::::::::::::::::::
::::::                          ::::::::::::::::::::::::::####                                                                ::::::::::::::::::::::::::::::::::
::::::                        ##::::::::::::::::::::::::::::::                                                                ::##::::::::::::::::::::::::::::::
::::                          ##::::::::::::::::::::::::::####                                                                ::##::::::::::::::::::::::::::::::
::::                          ##::::::::::::::::::::::::::::##                                                                ::##::::::::::::::::::::::::::::::
::::                          ####::::::::::::::::::::::::::##                                                                ::##::::::::::::::::::::::::::::::
::                              ::::::::::::::::::::::::::::::                                                                ::##::::::::::::::::::::::::::::::
::                            ##::::::::::::::::::::::::::##::                                                                ::##::::::::::::::::::::::::::::::
::                            ##::::::::::::::::::::::::::::::                                                                ::##::::::::::::::::::::::::::::::
::                            ##::::####::::::##::::::::::::                                                                    ##::::::::::::::::::::::::::::::
::                                                ::::                                                                                      ::::::::::::::::::::
################          ####################::##::::########################################################################################::##::::::::::::::
