::::##:######:::::::::::::::::::::::::#######################:::#:::::::::::::::
:::::: :::::::::::::::::::::::::::::::::                   #::::#      :::::::::
:::::  :  :::::::::::::::::::::::::::::::                  #::::#         :::: #
:::::     ::::::::::::::::::::::::::::::::                 #::::#      :       #
::::::    :::::::::::::::::::::::::::::     :              #::::#              #
::::::     ::::::::::::::::::::::::::::     :              #::::#              #
:::::::    :::::::::::::::::::::::::::::    ###:           #::::#            ::#
:::::::     ::::::::::::::::    ::::::::    ::##           #::::#           :::#
::::::::     :::::#::::::      :::::::::    :::            #::::#           ::::
:::::::::    :::  #:::        :::::::::::   ::: :          #::::#            :::
:::::::::    ::   ::         ::::::::::::   #::            #::::#          :   :
::::::::::   :   ##         :::::::::::::   #::#:          #::::#          ::: #
::::::::::     #::#:#       ::::::::::::    #::#            ####           ::::#
:::::::::#     #::::#        ::::::::::     #::#              ::          ::::::
:::::::::#:    #::::#        ::::::::       #::#                          ::::::
:::::::::#:    #::::#                       #::#             ####         ::::::
:::::::::::    #::::#         ::::         :#::##           #:::#        :::::::
:::::::::#:     #:::#                      ##::##           #:::#        :::::::
:::::::::#:     #:::#                      #:::##           #:::#        :::::::
::::::::##:     #:::#                      #::::#           #:::#       ::::::::
::::::::#::     #:::#                      #:::##           #:::#       ::::::::
::::::::: :     #:::#                      #:::##           #:::#       ::::::::
::::::::: :     #:::#                      ##::##           #:::#      #::::::::
:::::::::::      :::#                       ::::            #:::#      :::::::::
:::::::::#:      ::#######                  #:::            #:::#      :::::::::
:::::::#:::       :::::::#                  #::#           ##:::#      :::::::::
::::::::::#      : :::::##                  ::#:            ::::#     ::::::::::
::::::::::#      #:#::::#                   :::            :#:::#     ::::::::::
::::::::::#      :::::::#                  #:::             ##::#     ::::::::::
::::::::::#      #::::::#                  #:::            ##:::#     ::::::::::
::::::::::#     ##:::::::                  #:::             ::::#          :::::
::::::::::#     #:::::::#                  #::#:           :#:::#              #
::::::::::#      :::::::#                                  ##::##              #
::::::::::#      :::::::#                                   ::::#              #
::::::::::#     :::::::::#                  ###             ::::#              #
:::::::::##     ##:::::::#                 #:::#            #:::#             :#
:::::::::#      #::::::::#                 #:::#           ##:::#             :#
#:::::####      #::::::::#          ########:::#            #:::#             :#
#    ::  :      #:::::::::::#  #:#:::::::::::::#           ##:::#             :#
#               #:::::::::::#  #:::::::::::::::#           ##:::#              #
#               #:::::::::::#  #::::::::::::::::            :::##          #####
#               #:##::::::::   #:::::::::::::::##             ###          #::::
#                  ####        #::::::::::::::::                           #::::
#                              #::::::::::::::::#                          #::::
#                              #:::::::::::::::#                :          #::::
#                              #::::::::::::::::               :::         #::::
#                             ##:::::#::#:####::               ::          #::::
#                              ::::###:::::::                  :           #::::
#                                                             :            #::::
#                                           #::                            #::::
#                                          :::::                           #::::
#                                          #::::#            :             #::::
#                                          #::::#          ::::            #::::
#             ####:::  ::                  #::::#         ::::::      ######::::
#             #::#:####::                  #::::#       ::::::::      #:::::::::
#             #::::::::##                  #::::#      ::::::::::     #:::::::::
#             #::::::::#:                  #::::#       ::::::::::    #:::::::::
#             #:::::::::                   #:::##       ::::::::: :   #:::::::::
#             #::::::::##                  #:::::       ::::::::  :   #:::::::::
#             #:::::::::#                  #:::##       :::::::  :    #:::::::::
#              :::::::::#    ::::          #:::::       ::::::: :    ##:::::::::
#              #::::::::#   ::::::         #::::#        :::::       :::::::::::
#              #::::::::#    ::::::        #::::#        ::::       :#::::::::::
#              #::::::::#     ::::::       #:::##          :        :#::::::::::
#              :::::::::#      ::::::      #:::::                    #::::::::::
#               ::::::::#      :::::       ::::#:                    #::::::::::
#               ::::::::#       :::        ::::#:               :   :#::::::::::
#             # ::::::::#                  ::::#:               #:::::::::::::::
#             # ::::::::#                  ##::#                ##::::::::::::::
#             # #:::::::#                   :::#                ::::::::::::::::
#             #:::::::::#                   ::::                :#::::::::::::::
#             ###:::::::#                   ::::#               ::::::::::::::::
#              #::::::::#                   ::::#               :#::::::::::::::
#              #::::::::#                   ::::#               :#::::::::::::::
#              #::::::::#                   #:::                 :::::::::::::::
#              #::::::::#                   :#:                  :::::::::::::::
#              #::::::::#                                        #::::::::::::::
#              #::::::::#                                        #::::::::::::::
#              #::::::::#                                        #::::::::::::::
##########: ######::::::##########################################::::::::::::::
