#############################################################:::#:#:##::::::::::
#:                                                         :#:::#       ::::::::
#                                                           ::::#              #
#:                                                         ##:::#              #
#                                                          #::::#              #
#::                                 ::::::::               #::::#              #
#                                 :::::::::####:           #::::#           :  #
#                    :          ::::::::::::::::           ##:::#              #
#                              :::::::::::::::::           :::::#              #
#                             :::::::::::::::::::          #::::#              #
#                           :::::::::::::::::::::          ##:::#              #
#                          :::::::::::::::::::::#          :::::#              #
#      ###     ::###       :::::::::::::::::::::#          ##:#::              #
#    ::::#     #::::      ::::::::::::::::::::::#                              #
#   ::::::     #::::      :::::::::::::::::::::##                              #
# :::::::#     #::::#     ::::::::::::::::::::::#            ###               #
#::::::::#     #::::#     :::::::::::::::::::::##          :#::##              #
:::::::::#     #::::#     ::::::::::::::::::::::           :::::#              #
::::::::::     #::::#     ::::::::::::::::::::::           :#::##              #
:::::::::#     #::::#     ::::::::::::::::::::::            #:::#              #
:::::::::#     #::::#    :::::::::::::::::::::::            #:::#              #
:::::::::#     #::::#    :::::::::::::::::::::::           :#:::#              #
::::::::::     #::::#    :::::::::::::::::::::::            #:::#              #
:::::::::##    #::::#    :::::::::::::::::::::::            #:::#              #
::::::::::     #::::######::::::::::::::::::::::#           #:::#              #
:::::::##       :#::::::::::::::::::::::::::::::#           #:::#              #
::::::::##     :::::::::::::::::::::::::::::::::#          ##:::#              #
:::::::::      :::::::::::::::::::::::::::::::::#          #::::#              #
::::::::##:    :::::::::::::::::::::::::::::::::#          ##:::#              #
:::::::::#      :::::::::::::::::::::::::::::::::          :::::#              #
:::::::::       #::::::::::::::::::::::::::::::::          : :::#              #
::::::::::#    ##:::::::::::::::::::::::::::::::           #   :#              #
::::::::#:#    ::::::::::::::::::::::::::::###             : ::##              #
:::::::::::  # ::::::::::::::::::::::::::::#               #  ::#              #
:::::::::#   : ##:::::::::::::::::::::::::   ##            #::###              #
::::::::::   : #:::::::::::::::::::::::   ::::::           :::::#              #
::::::::::  :: :::::::::::::::::::::   :::::::::           ##:::#              #
:::::::::## :::#:::::::::::::::::#:::::::::::::#           #::::#              #
::::::::::##:::#::::::::::::::::::::::::::::::::           #::::#              #
:::::::::::::::#:::::::::::::::::::::::::::::::#           #::::#              #
:::::::::::::::#:::::::::::::::::::::::::::::::#           ######:           ###
::::::::::::::#::::::::::::::::::::::::::::::::#             : ::          #:#::
:::::::::::::::::::::::::::::::::::::::::::::::#                           #::::
:::::::::::::::::::::::::::::::::::::::::::::::#                           #::::
::::::::::::::::::::::::::::::::::::::::::::::::                           #::::
:::::::::::::::::::::::::::::::::::::::::::::::##                          #::::
::::::::::::::::::::::::::::::::::::::::#::::::#                           #::::
:::::::::::::::::::::::::::::::::::####:#  :::#                            #::::
:::::::::::::::::::::::::::::::::::::::::                                  #::::
:::::::::::::::::::::::::::::::::::::::::::###:                           :#::::
::::::::::::::::::::::::::::::::::::::::::::::::                          :#::::
::::::::::::::::::::::::::::::::::::::::::::::::#                         :#::::
::::::::::::::::::::::::::::::::::::::::::::::::#                         :#::::
::::::::::::::::::::::::::::::::::::::::::::::::#                       ####::::
::::::::::::::::::::::::::::::::::::::::::::::::#                    #::::#:::::
::::::::::::::::::::::::::::::::::::::::::::::::#                    ##:::::::::
::::::::::::::::::::::::::::::::::::::::::::::::#                    #::::::::::
::::::::::::::::::::::::::::::::::::::::::::::::#                    #::::::::::
::::::::::::::::::::::::::::::::::::::::::::::::#                    ##:::::::::
::::::::::::::::::::::::::::::::::::::::::::::::                     :::::::::::
:::::::::::::::::::::::::::::::::::::::::::::::##                    ##:::::::::
::::::::::::::::::::::::::::::::::::::::::::::::#                    #::::::::::
::::::::::::::::::::::::::::::::::::::::::::::::                     :::::::::::
:::::::::::::::::::::::::::::::::::::::::::::::#                     ##:::::::::
::::::::::::::::::::::::::::::::::::::::::::::::                     #::::::::::
:::::::::::::::::::::::::::::::::::::::::::::::##                    #::::::::::
::::::::::::::::::::::::::::::::::::::::::::::::#                ::###::::::::::
::::::::::::::::::::::::::::::::::::::::::::::::#                :::::::::::::::
::::::::::::::::::::::::::::::::::::::::::::::::#               #:::::::::::::::
::::::::::::::::::::::::::::::::::::::::::::::::#               #:::::::::::::::
::::::::::::::::::::::::::::::::::::::::::::::::#               #:::::::::::::::
::::::::::::::::::::::::::::::::::::::::::::::::#               #:::::::::::::::
::::::::::::::::::::::::::::::::::::::::::::::::#               #:::::::::::::::
:::::::::::::::::::::::::::::::::::::::::::::::::               #:::::::::::::::
:::::::::::::::::::::::::::::::::::::::::::::::::               #:::::::::::::::
::::::::::::::::::::::::::::::::::::::::::::#:                  #:::::::::::::::
:::::::::::::::::::::::::::::::::::::::::::                     #:::::::::::::::
:::::::::::::::::::::::::::::::::::::::                         #:::::::::::::::
::::::::::::::::::::::::::::::::::::                            #:::::::::::::::
:::::::::::::::::::::::::::::::::::##::#:########################:::::::::::::::
