::::::::::::::::::::::::::::::::::::::::::::::::::::::::::::::::##::::::::::::::
::::::::::::::::::::::::::::::::::::::::::::::::::::::::::::::::##     ::::::  :
::::::::::::::::::::::::::::::::::::::::::::::::::::::::::::::::#              #
::::::::::::::::::::::::::::::::::::::::::::::::::::::::::::::::#:   ::::      #
::::::::::::::::::::::::::::::::::::::::::::::::::::::::::::::::#              #
::::::::::::::::::::::::::::::::::::::::::::::::::::::::::::::::#              #
::::::::::::::::::::::::::::::::::::::::::::::::::::::::::::::::#              #
::::::::::::::::::::::::::::::::::::::::::::::::::::::::::::::::#              #
::::::::::::::::::::::::::::::::::::::::::::::::::::::::::::::::#              #
::::::::::::::::::::::::::::::::::::::::::::::::::::::::::::::::#              #
::::::::::::::::::::::::::::::::::::::::::::::::::::::::::::::::#              #
::::::::::::::::::::::::::::::::::::::::::::::::::::::::::::::::#              #
::::::::::::::::::::::::::::::::::::::::::::::::::::::::::::::::#              #
::::::::::::::::::::::::::::::::::::::::::::::::::::::::::::::::#              #
::::::::::::::::::::::::::::::::::::::::::::::::::::::::::::::::#              #
::::::::::::::::::::::::::::::::::::::::::::::::::::::::::::::::#              #
::::::::::::::::::::::::::::::::::::::::::::::::::::::::::::::::#              #
::::::::::::::::::::::::::::::::::::::::::::::::::::::::::::::::#              #
::::::::::::::::::::::::::::::::::::::::::::::::::::::::::::::::#              #
::::::::::::::::::::::::::::::::::::::::::::::::::::::::::::::::#              #
::::::::::::::::::::::::::::::::::::::::::::::::::::::::::::::::#              #
::::::::::::::::::::::::::::::::::::::::::::::::::::::::::::::::#              #
::::::::::::::::::::::::::::::::::::::::::::::::::::::::::::::::#              #
:::::::::::::::::::::::::::::::::::::::::::::::#      ::::::::::#              #
::::::::::::::::::::::::::::::::::::::::::::::::         :::::::#              #
:::::::::::::::::::::::::::::::::::::::::::::::#           :::::#              #
::::::::::::::::::::::::::::::::: ::::::::::::::           :::::#              #
:::::::::::::::::::::::::::::::::: ::::::::::::#           :::::#              #
::::::::::::::::::::::::::::::::::  ::::::::::::            ::::#              #
:::::::::::::::::::::::::::::::   :  :::::::::::           ##:::#              #
:::::::::::::::::::::::::::::::  : :  :::::::::#            #:::#              #
:::::::::::::::::::::::::::::       :  ::::::::#           #::::#              #
::::::::::::::::::::::::::::::       : :::::::::           #::::#             :#
:::::::::::::::::::::::::::::         : :::::::#           ##:::#              #
:::::::::::::::::::::::::::::            :::::::           #::::#              #
:::::::::::::::::::::::::::::             :::::#           :::::#              #
:::::::::::::::::::::::::::::              ##::#           #::::               #
::::::::::::::::::::::::::::                                ::##               #
::::::::::::::::::::::::::::::::                             ::                #
::::::::::::::::::::::::::::::#::#:::#::#:######                               #
::::::::::::::::::::::::::::::::::::::::::::::::                           ##:##
:::::::::::::::::::::::::::::::::::::::::::::::#                           #::::
:::::::::::::::::::::::::::::::::::::::::::::::#                           #::::
::::::::::::::::::::::::::::::::::::::::::::::::                           #::::
:::::::::::::::::::::::::::::::::::::::::::::::#                           #::::
:::::::::::::::::::::::::::::::::::::::::::::::#                           #::::
:::::::::::::::::::::::::::::::::::::::::::::::#                           #::::
:::::::::::::::::::::::::::::::::::::::::::::::#                           #::::
:::::::::::::::::::::::::::::::::::::::::::::::#                           #::::
:::::::::::::::::::::::::::::::::::::::::::::::#                           #::::
:::::::::::::::::::::::::::::::::::::::::::::::#                           #::::
::::::::::::::::::::::::::::::::::::::::::::::##                           #::::
:::::::::::::::::::::::::::::::::::::::::::::::#                           #::::
:::::::::::::::::::::::::::::::::::::::::::::::#                      ######::::
:::::::::::::::::::::::::::::::::::::::::::::::#                      #:::::::::
:::::::::::::::::::::::::::::::::::::::::::::::#                      #:::::::::
:::::::::::::::::::::::::::::::::::::::::::::::#                     :::::::::::
:::::::::::::::::::::::::::::::::::::::::::::::#                   :::::::::::::
:::::::::::::::::::::::::::::::::::::::::::::::#                  ::::::::::::::
:::::::::::::::::::::::::::::::::::::::::::::::#                   :::::::::::::
:::::::::::::::::::::::::::::::::::::::::::::::#                   :::::::::::::
:::::::::::::::::::::::::::::::::::::::::::::::                   ::::::::::::::
::::::::::::::::::::::::::::::::::::::::::::::::                   :::::::::::::
::::::::::::::::::::::::::::::::::::::::::::::##                  ::::::::::::::
::::::::::::::::::::::::::::::::::::::::::::::::                  ::::::::::::::
::::::::::::::::::::::::::::::::::::::::::::::::                 :::::::::::::::
::::::::::::::::::::::::::::::::::::::::::::::##                ::::::::::::::::
:::::::::::::::::::::::::::::::::::::::::::::::#               :#:::::::::::::::
:::::::::::::::::::::::::::::::::::::::::::::::#               :::::::::::::::::
:::::::::::::::::::::::::::::::::::::::::::::::#              ::::::::::::::::::
:::::::::::::::::::::::::::::::::::::::::::::::#             :::::::::::::::::::
:::::::::::::::::::::::::::::::::::::::::::::::#           : :::::::::::::::::::
::::::::::::::::::::::::::::::::::::::::::::::::         : :::::::::::::::::::::
::::::::::::::::::::::::::::::::::::::::::::::: :  :    ::::::::::::::::::::::::
:::::::::::::::::::::::::::::::::::::::::::::::::  :::::::::::::::::::::::::::::
::::::::::::::::::::::::::::::::::::::::::::::::::::::::::::::::::::::::::::::::
::::::::::::::::::::::::::::::::::::::::::::::::::::::::::::::::::::::::::::::::
::::::::::::::::::::::::::::::::::::::::::::::::::::::::::::::::::::::::::::::::
::::::::::::::::::::::::::::::::::::::::::::::::::::::::::::::::::::::::::::::::
::::::::::::::::::::::::::::::::::::::::::::::::::::::::::::::::::::::::::::::::
