######################::::::::::::::::::::::::::::::::::::::::::::::::::::::::::
##                   :::::::::::::::::::::::::::::::::::::::::::::::::::::::::::
#                    :::::::::::::::::::::::::::::::::::::::::::::::::::::::::::
 #                   :::::::::::::::::::::::::::::::::::::::::::::::::::::::::::
#                    :::::::::::::::::::::::::::::::::::::::::::::::::::::::::::
##                   :::::::::::::::::::::::::::::::::::::::::::::::::::::::::::
##                  ::::::::::::::::::::::::::::::::::::::::::::::::::::::::::::
##        :         ::::::::::::::::::::::::::::::::::::::::::::::::::::::::::::
##        ::        ::::::::::::::::::::::::::::::::::::::::::::::::::::::::::::
##     ## ::# #     ::::::::::::::::::::::::::::::::::::::::::::::::::::::::::::
##     ##:::##      ::::::::::::::::::::::::::::::::::::::::::::::::::::::::::::
##     ##:::###     ::::::::::::::::::::::::::::::::::::::::::::::::::::::::::::
##     ##:::###   ###:::::::::::::::::::::::::::::::::::::::::::::::::::::::::::
##     ##:::###   ###:::::::::::::::::::::::::::::::::::::::::::::::::::::::::::
#      ##:::###   ###::::::::::::::::::#::::::::::::::::::::::::::::::::::::::::
#      ##:::###   ###::::::::::::::::: #::::::::::::::::::::::::::::::::::::::::
#      ##:::##    #####:::#######::::: #::::::::::::::::::::::::::::::::::::::::
#      ##:::##    #######:       ::::  #::::::::::::::::::::::::::::::::::::::::
#      ##:::##          ::       ::::  #::::::::::::::::::::::::::::::::::::::::
#      ##:::##          ::       ::::  #:::::::::::##:::::::::::::::::::::::::::
#      ##:::##         ::::      :::   #:::::::::: ##:::::::::::::::::::::::::::
#      ##:::##        :::::       ::   #::::::::::   :::::::::::::::::::::::::::
#      #::::##       ::::::       :    ##::::::::   ::::::::::::::::::::::::::::
#      #::::##      ::::::: ##    :    ##::::::::   ::::::::::::::::::::::::::::
#      #::::##    # :::::::###         ##:::::::   :::::::::::::::::::::::::::::
#      #::::#    ##::::::::###         #::::::::  ::::::::::::::::::::::::::::::
#      #::::#     #::::::::###         #:::::::   ::#:::::::::::::::::::::::::::
#      ##:::#     #::::::::###         #:::::::  :: ##::::::::::::::::::::::::::
#      ##:::#     #::::::::###         #::::::   :  ##::::::::::::::::::::::::::
#      ##:::#     ##:::::::###         #::::::  :   ##::::::::::::::::::::::::::
#      ##:::#     ##:::::::###         #:::::  :    ##:::::::::::::##:::::::::::
#      ##:::#     ##:::::::###         #::::        ################ :::::::::::
#      ##:::#     ##:::::::###         #::::                        ::::::::::::
#      ##:::#     ##:::::::###         ######                       ::::::::::::
#      ##:::##   ###:::::::###                        ::           :::::::::::::
#      ##:::###  ####::::::###                      ::::           :::::::::::::
#     #######################                      :::::         #::::::::::::::
###             #############                  # ::::::::###     ##:::::::::::::
# ####            ###########                  ##::::::::##      ##:::::::::::::
#    ####          #                           ##::::::::##      ##:::::::::::::
#                                              #:::::::::##      ##:::::::::::::
#   ######                                     #:::::::::##      ##:::::::::::::
#####                     #                    #:::::::::##      ##:::::::::::::
##                  #######                    #::::#::::##      ##:::::::::::::
##                  #######                    #:::: ::::##      ##:::::::::::::
#                   ##:::#                     #:::: ::::##      ##:::::::::::::
#                   ##:::#                     #:::: ::::##      ##:::::::::::::
##                  ##:::#                     #:::: ::::##      ##:::::::::::::
#                   ##:::#                     #:::: ::::##      ##:::::::::::::
#                  ###:::#                     #::::#::::##      ##:::::::::::::
#                  ###:::#        #########################      ##:::::::::::::
#                  ###:::#       ####################            ##:::::::::::::
##    #            ###:::#        #::::::::::::##                #::::::::::::::
##   ##            ###:::#        #::::::::::::##                #::::::::::::::
## ####            ###:::#        ###############                #::::::::::::::
## ##############  ###:::#        ###############                #::::::::::::::
#  #############  ########        ##############                 #::::::::::::::
#  ####::::::: ## ########                                       #::::::::::::::
#  ####:::::::## #####                                           #::::::::::::::
#    ##:::::::## ######                                          #::::::::::::::
#    ##:::::::##     ##                 ##                       #::::::::::::::
#   ###:::::::##                        ###  #                   #::::::::::::::
#    ##:::::::##   #            ##      ######         ###########::::::::::::::
#    ##:::::::##   # ##############      #####         #::::######::::::::::::::
#    ##:::::::#####################   #                #:::::::::  :::::::::::::
#    ##::::::::::::::::::::##:# ###  ##                #:::::::::  :::::::::::::
#    ##::::::::::::::::::::::::::##                    #:::::::::  :::::::::::::
#    ####::::::::::::::::::::::::##       ####         #:::::::::   ::::::::::::
#   ################:########::::##    ############### #:::::::::   ::::::::::::
#    #########################:::##    ######:::::::## #:::::::::   ::::::::::::
#    #########################:::##    #:::::::::::::# #::::::::::   :::::::::::
#                 #####     ##:::##    #:::::::::::::# #::::::::::   :::::::::::
#                ########## ##:::##    #:::::::::::::# #::::::::::   :::::::::::
#                 ######### ##:::#     # :::::::     # #::::::::::    ::::::::::
#                 # ##########:::#                     ##:::::::::    ::::::::::
#   ####            ####### ##:::#                     #    #:::::    ::::::::::
# ########   #       ## ### ##:::####             :::  # :::::::::     :::::::::
# ########  ###    #  ##  #########                      ::::::::::    :::::::::
###############    # #    ######            # ##  #    #         ::    :::::::::
##################################################################:#####::::::::
