################################################################################
#################################################################              #
#################################################################              #
#################################################################              #
#################################################################              #
#################################################################              #
#################################################################              #
#################################################################              #
#################################################################              #
#################################################################              #
###########################################      ################              #
################################################     ############              #
#################################################         #######              #
#################################################             ##               #
#################################################                              #
#################################################                              #
################################################# ##     # ######              #
#################################################    ##### #####               #
#################################################  ####### ######              #
#################################################  ######  ######              #
#################################################  ######  ######              #
#################################################  ######  ######              #
#################################################   #####  ######              #
#################################################   #####  ######              #
#################################################   ####   ######              #
#################################################   ####   ######              #
#################################################    ###   ######              #
#################################################    ###   ######              #
#################################################    ###   ######              #
#################################################    ##    ######              #
#################################################          ######              #
#################################################          ######              #
#################################################          ######              #
###############################################            ######              #
################################################           ######              #
#################################################          ######              #
#################################################          ######              #
#################################################          ######              #
#################################################          ######              #
#################################################          ######              #
#################################################           ####           ##  #
#################################################            #             #####
#################################################                          #####
#################################################                          #####
#################################################                          #####
#################################################                          #####
#################################################                          #####
###############################################                            #####
#############################################                              #####
#################################################                          #####
#################################################            #             #####
#################################################            #             #####
#################################################           ##             #####
#################################################          ####       ##########
#################################################          ####       ##########
#################################################         #####       ##########
#################################################        ######       ##########
#################################################        ######       ##########
#################################################       #######       ##########
#################################################      ########       ##########
#################################################      ########       ##########
#################################################     #########       ##########
#################################################     #########       ##########
#################################################    ############     ##########
#################################################   ##############  # ##########
#################################################   ##############  # ##########
#################################################  #############################
#################################################  #############################
################################################# ##############################
################################################# ##############################
################################################# ##############################
################################################################################
################################################################################
################################################################################
################################################################################
################################################################################
################################################################################
################################################################################
################################################################################
################################################################################
