################################################################################
#############                                              ######      # #######
##############                                             ######        #    ##
###############                                            ######              #
#################                                          ######              #
##################                                         ######           #  #
###################                         ####           ######          ##  #
####################                       ######          ######              #
#####################                      ######          ######              #
######################                     ######          ######              #
#######################                    ######          ######              #
######################                     ######          ######              #
#####################                      ######          ######              #
#####################                      ######           #####              #
#####################                      ######                              #
#####################                      ######          ######              #
#####################                      ######          ######              #
#####################                      ######          ######              #
#####################                      ######          ######              #
#####################                      ######          ######              #
#####################                      ######          ######              #
#####################                      ######          ######              #
#####################                      #####           ######              #
#####################                      #####           ######              #
#########################                  ######          ######              #
#########################                  ######          ######              #
##########################                 ######          ######              #
##########################                 ######          ######              #
##########################                 #####           ######              #
##########################                 #####           ######              #
##########################                 ######          ######              #
##########################                 ######          ######              #
########### ##############                  #####          ######              #
########### ##############                                 ######              #
########### ##############                 ######          ######              #
###########  #############                 ######          ######              #
###########  #############                 ######          ######              #
###########  #############         ##   #########          ######              #
###########   ############### ###################          ######              #
######         ############## ###################          ######              #
#######        ############## ###################          ######              #
#######        ############## ###################                          #####
# ######       #############  ###################                          #####
### ####                      ###################                          #####
###  ####                      ##################                          #####
###   ###                      ##################                          #####
#  ##   ##                    ###################                          #####
##  ## #                       #################                           #####
#####                                      ###                             #####
#  ####  ##                                ######                          #####
########                                   ######                          #####
##########                                 ######                          #####
###########                                ######                          #####
#########     ###########                  ######                     ##########
#########     ###########                  ######                     ##########
##### ##      ###########                  ######                    ###########
######        ###########                  ######                    ###########
##### #       ###########                  ######                    ###########
##   #        ###########                  ######                     ##########
#             ###########                  ######                    ###########
#          ## ###########        ##        ######                    ###########
#         ### ###########                  ######                    ###########
#        #### ###########                  ######                    ###########
#       ##### ###########                  ######                    ###########
#   ## #### # ###########                  ######                    ###########
#  ## ###  ## ###########                  ######                    ###########
# #####  ###  ###########                  ######               ################
# ##  # ####  ###########                  ######               ################
#   #######   ###########     ###          ######               ################
# ## ######   ###########      ####        ######       ##      ################
##########    ###########       #####      ######       ##      ################
#########     ###########       #######    ######       #       ################
########      ###########        ########  ######               ################
########      ###########         ###############  #    #       ################
#######       ###########         ###############  #            ################
######        ###########          #############  ##            ################
#####         ###########           ############# ###           ################
###           ########### #          ############ ###     #  #  ################
#             ########### ###         ########### ###  #  #  # #################
################################################################################
