########################################
#         # #                ####      #
#         #   ##             ####     ##
#            ####    ####    ####    ###
#           ######   ####    ####     ##
#           ######   ####    ####    # #
###### ######        ####    ####      #
###### ####          ####    ####      #
###### ####          ####    ####      #
###### ####          ####    ####      #
###### ####          ####    ####      #
###### ####          ####    ####      #
###### ######        ####    ####      #
###### ######        ####    ####      #
###### ######        ####    ####      #
###### ######        ####    ####      #
###### ######        ###     ####      #
###### ######        ####    ####      #
###### ##################    ####      #
#  ### ##################    ####      #
#      ##################    ####    ###
#   #  ##################            ###
#              ##########            ###
##    ##       ##########            ###
#   ####      ###########            ###
#  #####    ####### #####            ###
##################   ####          #####
#################    ####          #####
#################    ####          #####
#############  ##    ####          #####
#############   ##   ####         ######
#############        ####         ######
#############        ####         ######
#############        ####       ########
#############        ####       ########
#############        ####       ########
#############        ####       ########
#############        ####       ########
#############                   ########
########################################
