 |      |      |      |      |      |      |      |      |      |      |      |      |      |      |      |      |      |      |      |      |      |      |      |      |      |      |      |      |      |      |      |      |      |      |      |      |      |      |      |     |

 |      |      |      |      |      |      |      |      |      |      |      |      |      |      |      |      |      |      |      |      |      |      |      |      |      |      |      |      |      |      |      |      |  720 |  720 |  720 |  720 |  720 |      |      |     |

 |      |      |      |      |      |      |      |      |      |      |      |      |      |      |      |      |      |      |      |      |      |      |      |      |      |      |      |      |      |      |      | 2430 | 3900 | 3900 | 3900 | 3900 | 1470 |      |      |     |

 |      |      |      |      |      |      |      |      |      |      |      |      |      |      |      |      |      |      |      |      |      |      |      |      |      |      |      |      |      |      |  930 | 3750 | 5220 | 5220 | 5220 | 4290 | 1470 |      |      |     |

 |      |      |      |      |      |      |      |      |      |      |      |      |      |      |      |      |      |      |      |      |      |      |      |      |      |      |      |      |      |      | 1080 | 3960 | 5430 | 5430 | 5430 | 4350 | 1470 |      |      |     |

 |      |      |      |      |      |      |      |      |      |      |      |      |      |      |      |      |      |      |      |      |      |      |      |      |      |      |      |      |      |      | 1710 | 4650 | 6120 | 6120 | 6120 | 4410 | 1470 |      |      |     |

 |      |      |      |      |      |      |      |      |      |      |      |      |      |      |      |      |      |      |      |      |      |      |      |      |      |      |      |      |      |      | 2100 | 5040 | 5790 | 5790 | 5790 | 3690 |  750 |      |      |     |

 |      |      |      |      |      |      |      |      |      |      |      |      |      |      |      |      |      |      |      |      |      |      |      |      |      |      |      |      |      |      | 2490 | 3000 | 3000 | 3000 | 3000 |  510 |      |      |      |     |

 |      |      |      |      |      |      |      |      |      |      |      |      |      |      |      |      |      |      |      |      |      |      |      |      |      |      |      |      |      |      | 1920 | 2040 | 2040 | 2040 | 2040 |  120 |      |      |      |     |

 |      |      |      |      |      |      |      |      |      |      |      |      |      |      |      |      |      |      |      |      |      |      |      |      |      |      |      |      |      |      | 2190 | 2250 | 2250 | 2250 | 2250 |   60 |      |      |      |     |

 |      |      |      |      |      |      |      |      |      |      |      |      |      |      |      |      |      |      |      |      |      |      |      |      |      |      |      |      |      |      | 1980 | 1980 | 1980 | 1980 | 1980 |      |      |      |      |     |

 |      |      |      |      |      |      |      |      |      |      |      |      |      |      |      |      |      |      |      |      |      |      |      |      |      |      |      |      |      |      | 2100 | 2100 | 2100 | 2100 | 2100 |      |      |      |      |     |

 |      |      |      |      |      |      |      |      |      |      |      |      |      |      |      |      |      |      |      |      |      |      |      |      |      |      |      |      |      |      | 1890 | 1890 | 1890 | 1890 | 1890 |      |      |      |      |     |

 |      |      |      |      |      |      |      |      |      |      |      |      |      |      |      |      |      |      |      |      |      |      |      |      |      |      |      |      |      |      | 1680 | 1680 | 1680 | 1680 | 1680 |      |      |      |      |     |

 |      |      |      |      |      |      |      |      |      |      |      |      |      |      |      |      |      |      |      |      |      |      |      |      |      |      |      |      |      |      | 1410 | 1410 | 1410 | 1410 | 1410 |      |      |      |      |     |

 |      |      |      |      |      |      |      |      |      |      |      |      |      |      |      |      |      |      |      |      |      |      |      |      |      |      |      |      |      |      | 1380 | 1380 | 1380 | 1380 | 1380 |      |      |      |      |     |

 |      |      |      |      |      |      |      |      |      |      |      |      |  450 | 1230 | 1800 | 2250 | 2640 | 2490 | 1980 | 1710 | 1710 | 1440 | 1260 |  990 |  690 |  240 |  120 |      |      |      | 1200 | 1200 | 1200 | 1200 | 1200 |      |      |      |      |     |

 |      |      |      |      |      |      |      |      |      |      |      |      | 2460 | 3240 | 3810 | 4260 | 4650 | 2490 | 1980 | 1770 | 1830 | 1620 | 4860 | 4650 | 4290 | 3780 | 3600 |   60 |      |      | 1320 | 1320 | 1320 | 1320 | 1320 |      |      |      |      |     |

 |      |      |      |      |      |      |      |      |      |      |      |      | 2460 | 3240 | 3810 | 4260 | 4650 | 2490 | 1980 | 1770 | 1830 | 1620 | 6060 | 6120 | 5760 | 5250 | 5070 |  330 |      |  270 | 1590 | 1590 | 1590 | 1590 | 1320 |      |      |      |      |     |

 |      |      |      |      |      |      |      |      |      |      |      |      | 2490 | 3270 | 3840 | 4290 | 4680 | 2490 | 1980 | 1770 | 1830 | 1620 | 11460 | 13950 | 14550 | 14700 | 15030 | 5280 | 2880 | 2220 | 2730 | 2220 | 1830 | 1470 | 1170 |      |      |      |      |     |

 |      |      |      |      |      |      |      |      |      |      |      |      | 2490 | 3270 | 3840 | 4290 | 4680 | 2490 | 1980 | 1770 | 1830 | 1620 | 11460 | 13950 | 14550 | 14700 | 15030 | 5280 | 2880 | 2220 | 2340 | 1830 | 1440 | 1080 |  780 |      |      |      |      |     |

 |      |      |      |      |      |      |      |      |      |      |      |      | 2040 | 2040 | 2040 | 2040 | 2040 |      |      |   60 |  120 |  180 | 10200 | 12960 | 13860 | 14460 | 14910 | 5280 | 2880 | 2220 | 2010 | 1500 | 1110 |  750 |  450 |      |      |      |      |     |

 |      |      |      |      |      |      |      |      |      |      |      |      |      |      |      |      |      |      |      |      |      |      | 6600 | 9300 | 10260 | 10920 | 11430 | 5220 | 2880 | 2220 | 1710 | 1200 |  810 |  450 |  150 |      |      |      |      |     |

 |      |      |      |      |      |      |      |      |      |      |      |      |      |      |      |      |      |      |      |      |      |      | 5400 | 7830 | 8790 | 9450 | 9960 | 4950 | 2880 | 1950 | 1290 |  780 |  390 |   30 |      |      |      |      |      |     |

 |      |      |      |      |      |      |      |      |      |      |      |      |      |      |      |      |      |      |      |      |      |      |      |      |      |      |      |      |      |      |      |      |      |      |      |      |      |      |      |     |

 |      |      |      |      |      |      |      |      |      |      |      |      |      |      |      |      |      |      |      |      |      |      |      |      |      |      |      |      |      |      |      |      |      |      |      |      |      |      |      |     |

 |      |      |      |      |      |      |      |      |      |      |      |      |      |      |      |      |      |      |      |      |      |      |      |      |      |      |      |      |      |      |      |      |      |      |      |      |      |      |      |     |

 |      |      |      |      |      |      |      |      |      |      |      |      |      |      |      |      |      |      |      |      |      |      |      |      |      |      |      |      |      |      |      |      |      |      |      |      |      |      |      |     |

 |      |      |      |      |      |      |      |      |      |      |      |      |      |      |      |      |      |      |      |      |      |      |      |      |      |      |      |      |      |      |      |      |      |      |      |      |      |      |      |     |

 |      |      |      |      |      |      |      |      |      |      |      |      |      |      |      |      |      |      |      |      |      |      |      |      |      |      |      |      |      |      |      |      |      |      |      |      |      |      |      |     |

 |      |      |      |      |      |      |      |      |      |      |      |      |      |      |      |      |      |      |      |      |      |      |      |      |      |      |      |      |      |      |      |      |      |      |      |      |      |      |      |     |

 |      |      |      |      |      |      |      |      |      |      |      |      |      |      |      |      |      |      |      |      |      |      |      |      |      |      |      |      |      |      |      |      |      |      |      |      |      |      |      |     |

 |      |      |      |      |      |      |      |      |      |      |      |      |      |      |      |      |      |      |      |      |      |      |      |      |      |      |      |      |      |      |      |      |      |      |      |      |      |      |      |     |

 |      |      |      |      |      |      |      |      |      |      |      |      |      |      |      |      |      |      |      |      |      |      |      |      |      |      |      |      |      |      |      |      |      |      |      |      |      |      |      |     |

 |      |      |      |      |      |      |      |      |      |      |      |      |      |      |      |      |      |      |      |      |      |      |      |      |      |      |      |      |      |      |      |      |      |      |      |      |      |      |      |     |

 |      |      |      |      |      |      |      |      |      |      |      |      |      |      |      |      |      |      |      |      |      |      |      |      |      |      |      |      |      |      |      |      |      |      |      |      |      |      |      |     |

 |      |      |      |      |      |      |      |      |      |      |      |      |      |      |      |      |      |      |      |      |      |      |      |      |      |      |      |      |      |      |      |      |      |      |      |      |      |      |      |     |

 |      |      |      |      |      |      |      |      |      |      |      |      |      |      |      |      |      |      |      |      |      |      |      |      |      |      |      |      |      |      |      |      |      |      |      |      |      |      |      |     |

 |      |      |      |      |      |      |      |      |      |      |      |      |      |      |      |      |      |      |      |      |      |      |      |      |      |      |      |      |      |      |      |      |      |      |      |      |      |      |      |     |

 |      |      |      |      |      |      |      |      |      |      |      |      |      |      |      |      |      |      |      |      |      |      |      |      |      |      |      |      |      |      |      |      |      |      |      |      |      |      |      |     |

