 |      |      |      |      |      |      |      |      |      |      |      |      |      |      |      |      |      |      |      |      |      |      |      |      |      |      |      |      |      |      |      |      |      |      |      |      |      |      |      |     |

 |      |      |      |      |      |      |      |      |      |      |      |      |      |      |      |      |      |      |      |      |      |      |      |      |      |      |      |      |      |      |  570 | 3600 | 4950 | 4950 | 4950 | 4380 | 1350 |      |      |     |

 |      |      |      |      |      |      |      |      |      |      |      |      |      |      |      |      |      |      |      |      |      |      |      |      |      |      |      |      |      |      |  960 | 5310 | 6660 | 6660 | 6660 | 5700 | 1350 |      |      |     |

 |      |      |      |      |      |      |      |      |      |      |      |      |      |      |      |      |      |      |      |      |      |      |      |      |      |      |      |      |      |      | 1350 | 6240 | 7590 | 7590 | 7590 | 6240 | 1350 |      |      |     |

 |      |      |      |      |      |      |      |      |      |      |      |      |      |      |      |      |      |      |      |      |      |      |      |      |      |      |      |      |      |      | 1830 | 6720 | 8070 | 8070 | 8070 | 6240 | 1350 |      |      |     |

 |      |      |      |      |      |      |      |      |      |      |      |      |      |      |      |      |      |      |      |      |      |      |      |      |      |      |      |      |      |      | 2250 | 7140 | 8490 | 8490 | 8490 | 6240 | 1350 |      |      |     |

 |      |      |      |      |      |      |      |      |      |      |      |      |      |      |      |      |      |      |      |      |      |      |      |      |      |      |      |      |      |      | 2070 | 3930 | 3930 | 3930 | 3930 | 1860 |      |      |      |     |

 |      |      |      |      |      |      |      |      |      |      |      |   90 |   90 |   90 |   90 |   90 |      |      |      |      |      |      |      |      |      |      |      |      |      |      | 2100 | 2640 | 2640 | 2640 | 2640 |  540 |      |      |      |     |

 |      |      |      |      |      |      |      |      |      |      |      |  660 |  660 |  660 |  660 |  660 |      |      |      |      |      |      |      |      |      |      |      |      |      |      | 1740 | 2040 | 2040 | 2040 | 2040 |  300 |      |      |      |     |

 |      |      |      |      |      |      |      |      |      |      |      |  990 |  990 |  990 |  990 |  990 |      |      |      |      |      |      |      |      |      |      |      |      |      |      | 1650 | 3480 | 3480 | 3480 | 3480 | 1830 |      |      |      |     |

 |      |      |      |      |      |      |      |      |      |      |      | 2640 | 2640 | 2640 | 2640 | 2640 |      |      |      |      |      |      |      |      |      |      |      |      |      |      | 1560 | 4290 | 4290 | 4290 | 4290 | 2730 |      |      |      |     |

 |      |      |      |      |      |      |      |      |      |      |      | 2850 | 2850 | 2850 | 2850 | 2850 |      |      |      |      |      |      |      |      |      |      |      |      |      |      | 1440 | 5340 | 5340 | 5340 | 5340 | 3900 |      |      |      |     |

 |      |      |      |      |      |      |      |      |      |      |      | 5190 | 5280 | 5280 | 5280 | 5280 |   90 |      |      |      |      |      |      |      |      |      |      |      |      |      | 1410 | 5340 | 5340 | 5340 | 5340 | 3930 |      |      |      |     |

 |      |      |      |      |      |      |      |      |      |      |      | 4620 | 5790 | 6390 | 6390 | 6390 | 1770 |  600 |      |      |      |      |      |      |      |      |      |      |      |      | 1710 | 5820 | 5820 | 5820 | 5820 | 4110 |      |      |      |     |

 |      |      |      |      |      |      |      |      |      |      |      | 4290 | 5460 | 6180 | 6720 | 7020 | 2730 | 1560 |  840 |  300 |      |      |      |      |      |      |      |      |      |      | 1770 | 4440 | 4440 | 4440 | 4440 | 2670 |      |      |      |     |

 |      |      |      |      |      |      |      |      |      |      |      | 2640 | 3810 | 4530 | 5070 | 5490 | 3210 | 2220 | 1500 |  960 |  540 |  180 |      |      |      |      |      |      |      |      | 1560 | 4200 | 4200 | 4200 | 4200 | 2640 |      |      |      |     |

 |      |      |      |      |      |      |      |      |      |      |      | 2430 | 3600 | 4320 | 4860 | 5280 | 3210 | 2340 | 1890 | 1770 | 2040 | 1980 | 1890 | 1620 | 1200 |  510 |  210 |      |      |      | 1470 | 2940 | 2940 | 2940 | 2940 | 1470 |      |      |      |     |

 |      |      |      |      |      |      |      |      |      |      |      |      | 1080 | 1800 | 2340 | 2760 | 3120 | 2340 | 1890 | 1770 | 2040 | 2640 | 6120 | 6510 | 6090 | 5400 | 4440 |  660 |      |      | 1260 | 2700 | 2700 | 2700 | 2700 | 1440 |      |      |      |     |

 |      |      |      |      |      |      |      |      |      |      |      |      |      |  120 |  660 | 1080 | 1440 | 1740 | 1890 | 1770 | 2040 | 2640 | 6120 | 6780 | 7020 | 6840 | 6360 | 2640 | 1710 | 1140 | 1800 | 2280 | 2220 | 2220 | 2130 |  960 |      |      |      |     |

 |      |      |      |      |      |      |      |      |      |      |      |      |      |      |      |  120 |  480 |  780 | 1050 | 1470 | 2040 | 2640 | 6120 | 6780 | 7020 | 6840 | 6360 | 3000 | 2400 | 2040 | 2250 | 2640 | 2220 | 1890 | 1590 |  870 |      |      |      |     |

 |      |      |      |      |      |      |      |      |      |      |      |      |      |      |      |      |      |  120 |  390 |  810 | 1500 | 2460 | 6120 | 6780 | 7020 | 6840 | 6360 | 3000 | 2400 | 2040 | 2130 | 1650 | 1230 |  900 |  600 |      |      |      |      |     |

 |      |      |      |      |      |      |      |      |      |      |      |      |      |      |      |      |      |      |      |      |      |  660 | 4230 | 5160 | 5820 | 6330 | 6150 | 3000 | 2400 | 2040 | 1950 | 1470 | 1050 |  720 |  420 |      |      |      |      |     |

 |      |      |      |      |      |      |      |      |      |      |      |      |      |      |      |      |      |      |      |      |      |      |      |  270 |  930 | 1440 | 1920 | 2340 | 2400 | 2040 | 1770 | 1290 |  870 |  540 |  240 |      |      |      |      |     |

 |      |      |      |      |      |      |      |      |      |      |      |      |      |      |      |      |      |      |      |      |      |      |      |      |      |      |      |  360 |  690 |  900 |  900 |  900 |  540 |  210 |      |      |      |      |      |     |

 |      |      |      |      |      |      |      |      |      |      |      |      |      |      |      |      |      |      |      |      |      |      |      |      |      |      |      |      |      |      |      |      |      |      |      |      |      |      |      |     |

 |      |      |      |      |      |      |      |      |      |      |      |      |      |      |      |      |      |      |      |      |      |      |      |      |      |      |      |      |      |      |      |      |      |      |      |      |      |      |      |     |

 |      |      |      |      |      |      |      |      |      |      |      |      |      |      |      |      |      |      |      |      |      |      |      |      |      |      |      |      |      |      |      |      |      |      |      |      |      |      |      |     |

 |      |      |      |      |      |      |      |      |      |      |      |      |      |      |      |      |      |      |      |      |      |      |      |      |      |      |      |      |      |      |      |      |      |      |      |      |      |      |      |     |

 |      |      |      |      |      |      |      |      |      |      |      |      |      |      |      |      |      |      |      |      |      |      |      |      |      |      |      |      |      |      |      |      |      |      |      |      |      |      |      |     |

 |      |      |      |      |      |      |      |      |      |      |      |      |      |      |      |      |      |      |      |      |      |      |      |      |      |      |      |      |      |      |      |      |      |      |      |      |      |      |      |     |

 |      |      |      |      |      |      |      |      |      |      |      |      |      |      |      |      |      |      |      |      |      |      |      |      |      |      |      |      |      |      |      |      |      |      |      |      |      |      |      |     |

 |      |      |      |      |      |      |      |      |      |      |      |      |      |      |      |      |      |      |      |      |      |      |      |      |      |      |      |      |      |      |      |      |      |      |      |      |      |      |      |     |

 |      |      |      |      |      |      |      |      |      |      |      |      |      |      |      |      |      |      |      |      |      |      |      |      |      |      |      |      |      |      |      |      |      |      |      |      |      |      |      |     |

 |      |      |      |      |      |      |      |      |      |      |      |      |      |      |      |      |      |      |      |      |      |      |      |      |      |      |      |      |      |      |      |      |      |      |      |      |      |      |      |     |

 |      |      |      |      |      |      |      |      |      |      |      |      |      |      |      |      |      |      |      |      |      |      |      |      |      |      |      |      |      |      |      |      |      |      |      |      |      |      |      |     |

 |      |      |      |      |      |      |      |      |      |      |      |      |      |      |      |      |      |      |      |      |      |      |      |      |      |      |      |      |      |      |      |      |      |      |      |      |      |      |      |     |

 |      |      |      |      |      |      |      |      |      |      |      |      |      |      |      |      |      |      |      |      |      |      |      |      |      |      |      |      |      |      |      |      |      |      |      |      |      |      |      |     |

 |      |      |      |      |      |      |      |      |      |      |      |      |      |      |      |      |      |      |      |      |      |      |      |      |      |      |      |      |      |      |      |      |      |      |      |      |      |      |      |     |

 |      |      |      |      |      |      |      |      |      |      |      |      |      |      |      |      |      |      |      |      |      |      |      |      |      |      |      |      |      |      |      |      |      |      |      |      |      |      |      |     |

 |      |      |      |      |      |      |      |      |      |      |      |      |      |      |      |      |      |      |      |      |      |      |      |      |      |      |      |      |      |      |      |      |      |      |      |      |      |      |      |     |

