 |      |      |      |      |      |      |      |      |      |      |      |      |      |      |      |      |      |      |      |      |      |      |      |      |      |      |      |      |      |      |      |      |      |      |      |      |      |      |      |     |

 |      |      |      |      |      |      |      |      |      |      |      |      |      |      |      |      |      |      |      |      |      |      |      |      |      |      |      |      |      |      |      |      |  300 |  330 |  330 |  330 |  330 |   30 |      |     |

 |      |      |      |      |      |      |      |      |      |      |      |      |      |      |      |      |      |      |      |      |      |      |      |      |      |      |      |      |      |      |      |      |  450 |  480 |  480 |  480 |  480 |   30 |      |     |

 |      |      |      |      |      |      |      |      |      |      |      |      |      |      |      |      |      |      |      |      |      |      |      |      |      |      |      |      |      |      |      |      |  600 |  630 |  630 |  630 |  630 |   30 |      |     |

 |      |      |      |      |      |      |      |      |      |      |      |      |      |      |      |      |      |      |      |      |      |      |      |      |      |  480 |  480 |  480 |  480 |  480 |      |      |  750 |  780 |  780 |  780 |  780 |   30 |      |     |

 |      |      |      |      |      |      |      |      |      |      |      |      |      |      |      |      |      |      |      |      |      |      |      |      |      |  780 |  780 |  780 |  780 |  780 |      |      |  900 |  930 |  930 |  930 |  930 |   30 |      |     |

 |      |      |      |      |      |      |      |      |      |      |      |      |      |      |      |      |      |      |      |      |      |      |      |      |   60 | 1080 | 1080 | 1080 | 1080 | 1020 |      |      |  750 |  750 |  750 |  750 |  750 |      |      |     |

 |      |      |      |      |      |      |      |      |      |      |      |      |      |      |      |      |      |      |      |      |      |      |      |      |  240 | 1290 | 1410 | 1410 | 1410 | 1170 |  120 |      |  750 |  750 |  750 |  750 |  750 |      |      |     |

 |      |      |      |      |      |      |      |      |      |      |      |      |      |      |      |      |      |      |      |      |      |      |      |      |  390 | 1440 | 1710 | 1710 | 1710 | 1320 |  270 |      |  750 |  750 |  750 |  750 |  750 |      |      |     |

 |      |      |      |      |      |      |      |      |      |      |      |      |      |      |      |      |      |      |      |      |      |      |      |      |  540 | 1110 | 1530 | 1530 | 1530 |  990 |  420 |      |  750 |  750 |  750 |  750 |  750 |      |      |     |

 |      |      |      |      |      |      |      |      |      |      |      |      |      |      |      |      |      |      |      |      |      |      |      |      |  690 |  960 | 1530 | 1530 | 1530 |  840 |  570 |      |  750 |  750 |  750 |  750 |  750 |      |      |     |

 |      |      |      |      |      |      |      |      |      |      |      |      |      |      |      |      |      |      |      |      |      |      |      |      |  780 |  810 | 1530 | 1530 | 1530 |  750 |  720 |      |  750 |  750 |  750 |  750 |  750 |      |      |     |

 |      |      |      |      |      |      |      |      |      |      |      |      |      |      |      |      |      |      |      |      |      |      |      |      |  750 | 1230 | 1980 | 1980 | 1980 | 1230 |  750 |      |  750 |  750 |  750 |  750 |  750 |      |      |     |

 |      |      |      |      |      |      |      |      |      |      |      |      |      |      |      |      |      |      |      |      |      |      |      |      |  600 | 1230 | 1980 | 1980 | 1980 | 1380 |  750 |      |  750 |  750 |  750 |  750 |  750 |      |      |     |

 |      |      |      |      |      |      |      |      |      |      |      |      |      |      |      |      |      |      |      |      |      |      |      |      |  450 | 1230 | 1980 | 1980 | 1980 | 1530 |  750 |      |  750 |  750 |  750 |  750 |  750 |      |      |     |

 |      |      |      |      |      |      |      |      |      |      |      |      |      |      |      |      |      |      |      |      |      |      |      |      |  450 | 1230 | 1980 | 1980 | 1980 | 1530 |  750 |      |  750 |  750 |  750 |  750 |  750 |      |      |     |

 |      |      |      |      |      |      |      |      |      |      |      |      |      |      |      |      |      |      |      |      |      |      |      |      |  450 | 1230 | 1980 | 1980 | 1980 | 1530 |  750 |      |  750 |  750 |  750 |  750 |  750 |      |      |     |

 |      |      |      |      |      |      |      |      |      |      |      |      |      |      |      |      |      |      |      |      |      |      |      |      |  450 |  750 | 1500 | 1500 | 1500 | 1050 |  750 |      |  750 |  750 |  750 |  750 |  750 |      |      |     |

 |      |      |      |      |      |      |      |      |      |      |      |      |      |      |      |      |      |      |      |      |      |      |      |      |  600 |  750 | 1500 | 1560 | 1560 |  960 |  810 |   90 |  780 |  780 |  780 |  780 |  750 |      |      |     |

 |      |      |      |      |      |      |      |      |      |      |      |      |      |      |      |      |      |      |      |      |      |      |      |      |  750 |  750 | 1350 | 1530 | 1680 |  930 |  930 |  510 |  930 |  780 |  780 |  780 |  600 |      |      |     |

 |      |      |      |      |      |      |      |      |      |      |      |      |      |      |      |      |      |      |      |      |      |      |      |      |  750 |  750 | 1200 | 1380 | 1560 |  810 |  810 |  690 |  960 |  780 |  780 |  780 |  450 |      |      |     |

 |      |      |      |      |      |      |      |      |      |      |      |      |      |      |      |      |      |      |      |      |      |      |      |      |  720 |  750 | 1050 | 1230 | 1410 |  690 |  810 |  870 |  990 |  810 |  810 |  660 |  300 |      |      |     |

 |      |      |      |      |      |      |      |      |      |      |      |      |      |      |      |      |      |      |      |      |      |      |      |      |  570 |  780 |  930 | 1110 | 1290 |  720 |  840 | 1050 | 1020 |  840 |  840 |  510 |  150 |      |      |     |

 |      |      |      |      |      |      |      |      |      |      |      |      |      |      |      |      |      |      |      |      |      |      |      |      |  420 |  720 |  840 |  960 | 1140 |  900 |  930 | 1140 | 1020 |  840 |  660 |  330 |      |      |      |     |

 |      |      |      |      |      |      |      |      |      |      |      |      |      |      |      |      |      |      |      |      |      |      |      |      |  270 |  570 |  780 |  990 | 1200 | 1170 | 1200 | 1170 |  960 |  750 |  510 |  180 |      |      |      |     |

 |      |      |      |      |      |      |      |      |      |      |      |      |      |      |      |      |      |      |      |      |      |      |      |      |  120 |  420 |  630 |  840 | 1020 | 1140 | 1170 |  990 |  780 |  600 |  360 |   30 |      |      |      |     |

 |      |      |      |      |      |      |      |      |      |      |      |      |      |      |      |      |      |      |      |      |      |      |      |      |      |  270 |  480 |  690 |  870 | 1110 | 1020 |  810 |  600 |  420 |  180 |      |      |      |      |     |

 |      |      |      |      |      |      |      |      |      |      |      |      |      |      |      |      |      |      |      |      |      |      |      |      |      |   90 |  300 |  510 |  690 |  930 |  840 |  630 |  420 |  240 |      |      |      |      |      |     |

 |      |      |      |      |      |      |      |      |      |      |      |      |      |      |      |      |      |      |      |      |      |      |      |      |      |      |   90 |  300 |  480 |  540 |  540 |  450 |  240 |   60 |      |      |      |      |      |     |

 |      |      |      |      |      |      |      |      |      |      |      |      |      |      |      |      |      |      |      |      |      |      |      |      |      |      |      |      |      |      |      |      |      |      |      |      |      |      |      |     |

 |      |      |      |      |      |      |      |      |      |      |      |      |      |      |      |      |      |      |      |      |      |      |      |      |      |      |      |      |      |      |      |      |      |      |      |      |      |      |      |     |

 |      |      |      |      |      |      |      |      |      |      |      |      |      |      |      |      |      |      |      |      |      |      |      |      |      |      |      |      |      |      |      |      |      |      |      |      |      |      |      |     |

 |      |      |      |      |      |      |      |      |      |      |      |      |      |      |      |      |      |      |      |      |      |      |      |      |      |      |      |      |      |      |      |      |      |      |      |      |      |      |      |     |

 |      |      |      |      |      |      |      |      |      |      |      |      |      |      |      |      |      |      |      |      |      |      |      |      |      |      |      |      |      |      |      |      |      |      |      |      |      |      |      |     |

 |      |      |      |      |      |      |      |      |      |      |      |      |      |      |      |      |      |      |      |      |      |      |      |      |      |      |      |      |      |      |      |      |      |      |      |      |      |      |      |     |

 |      |      |      |      |      |      |      |      |      |      |      |      |      |      |      |      |      |      |      |      |      |      |      |      |      |      |      |      |      |      |      |      |      |      |      |      |      |      |      |     |

 |      |      |      |      |      |      |      |      |      |      |      |      |      |      |      |      |      |      |      |      |      |      |      |      |      |      |      |      |      |      |      |      |      |      |      |      |      |      |      |     |

 |      |      |      |      |      |      |      |      |      |      |      |      |      |      |      |      |      |      |      |      |      |      |      |      |      |      |      |      |      |      |      |      |      |      |      |      |      |      |      |     |

 |      |      |      |      |      |      |      |      |      |      |      |      |      |      |      |      |      |      |      |      |      |      |      |      |      |      |      |      |      |      |      |      |      |      |      |      |      |      |      |     |

 |      |      |      |      |      |      |      |      |      |      |      |      |      |      |      |      |      |      |      |      |      |      |      |      |      |      |      |      |      |      |      |      |      |      |      |      |      |      |      |     |

