 |      |      |      |      |      |      |      |      |      |      |      |      |      |      |      |      |      |      |      |      |      |      |      |      |      |      |      |      |      |      |      |      |      |      |      |      |      |      |      |     |

 |      |      |      |      |      |      |      |      |      |      |      |      |      |      |      |      |      |      |      |      |      |      |      |      |      |      |      |      |      |      |      |      |      |      |      |      |      |      |      |     |

 |      |      |      |      |      |      |      |      |      |      |      |      |      |      |      |      |      |      |      |      |      |      |      |      |      |      |      |      |      |      |      |      |      |      |      |      |      |      |      |     |

 |      |      |      |      |      |      |      |      |      |      |      |      |      |      |      |      |      |      |      |      |      |      |      |      |      |      |      |      |      |      |      |      |      |      |      |      |      |      |      |     |

 |      |      |      |      |      |      |      |      |      |      |      |      |      |      |      |      |      |      |      |      |      |      |      |      |      |      |      |      |      |      |      |      |      |      |      |      |      |      |      |     |

 |      |      |      |      |      |      |      |      |      |      |      |      |      |      |      |      |      |      |      |      |      |      |      |      |      |      |      |      |      |      |      |      |      |      |      |      |      |      |      |     |

 |      |      |      |      |      |      |      |      |      |      |      |      |      |      |      |      |      |      |      |      |      |      |      |      |      |      |      |      |      |      |      |      |      |      |      |      |      |      |      |     |

 |      |      |      |      |      |      |      |      |      |      |      |      |      |      |      |      |      |      |      |      |      |      |      |      |      |      |      |      |      |      |      |      |      |      |      |      |      |      |      |     |

 |      |      |      |      |      |      |      |      |      |      |      |      |      |      |      |      |      |      |      |      |      |      |      |      |      |      |      |      |      |      |      |      |      |      |      |      |      |      |      |     |

 |      |      |      |      |      |      |      |      |      |      |      |      |      |      |      |      |      |      |      |      |      |      |      |      |      |      |      |      |      |      |      |      |      |      |      |      |      |      |      |     |

 |      |      |      |      |      |      |      |      |      |      |      |      |      |      |      |      |      |      |      |      |      |      |      |      |      |      |      |      |      |      |      |      |      |      |      |      |      |      |      |     |

 |      |      |      |      |      |      |      |      |      |      |      |      |      |      |      |      |      |      |      |      |      |      |      |      |      |      |      |      |      |      |      |      |      |      |      |      |      |      |      |     |

 |      |      |      |      |      |      |      |      |      |      |      |      |      |      |      |      |      |      |      |      |      |      |      |      |      |      |      |      |      |      |      |      |      |      |      |      |      |      |      |     |

 |      |      |      |      |      |      |      |      |      |      |      |      |      |      |      |      |      |      |      |      |      |      |      |      |      |      |      |      |      |      |      |      |      |      |      |      |      |      |      |     |

 |      |      |      |      |      |      |      |      |      |      |      |      |      |      |      |      |      |      |      |      |      |      |      |      |      |      |      |      |      |      |      |      |      |      |      |      |      |      |      |     |

 |      |      |      |      |      |      |      |      |      |      |      |      |      |      |      |      |      |      |      |      |      |      |      |      |      |      |      |      |      |      |      |      |      |      |      |      |      |      |      |     |

 |      |      |      |      |      |      |      |      |      |      |      |      |      |      |      |      |      |      |      |      |      |      |      |      |      |      |      |      |      |      |      |      |      |      |      |      |      |      |      |     |

 |      |      |      |      |      |      |      |      |      |      |      |      |      |      |      |      |      |      |      |      |      |      |      |      |      |      |      |      |      |      |      |      |      |      |      |      |      |      |      |     |

 |      |      |      |      |      |      |      |      |      |      |      |      |      |      |      |      |      |      |      |      |      |      |      |      |      |      |      |      |      |      |      |      |      |      |      |      |      |      |      |     |

 |      |      |      |      |      |      |      |      |      |      |      |  140 | 87650 | 87650 | 87650 | 87650 | 87510 |      |      |      |      |      |      |      |      |      |      |      |      |      |      |      |      |      |      |      |      |      |      |     |

 |      |      |      |      |      |      |      |      |      |      |      |  430 | 89820 | 89820 | 89820 | 89820 | 89390 |      |      |      |      |      |      |      |      |      |      |      |      |      |      |      |      |      |      |      |      |      |      |     |

 |      |      |      |      |      |      |      |      |      |      |      |  430 | 91000 | 91090 | 91090 | 91090 | 90660 |   90 |      |      |      |      |      |      |      |      |      |      |      |      |      |      |      |      |      |      |      |      |      |     |

 |      |      |      |      |      |      |      |      |      |      |      |  430 | 91000 | 93200 | 93200 | 93200 | 92770 | 2200 |      |      |      |      |      |      |      |      |      |      |      |      |      |      |      |      |      |      |      |      |      |     |

 |      |      |      |      |      |      |      |      |      |      |      |  430 | 91000 | 93250 | 94990 | 94990 | 94560 | 3990 | 1740 |      |      |      |      |      |      |      |      |      |      |      |      |      |      |      |      |      |      |      |      |     |

 |      |      |      |      |      |      |      |      |      |      |      |  290 | 3350 | 5600 | 8440 | 8440 | 8150 | 5090 | 2840 |      |      |      |      |      |      |      |      |      |      |      |      |      |      |      |      |      |      |      |      |     |

 |      |      |      |      |      |      |      |      |      |      |      |      | 1180 | 3430 | 7070 | 7070 | 7070 | 5890 | 3640 |      |      |      |      |      |      |      |      |      |      |      |      |      |      |      |      |      |      |      |      |     |

 |      |      |      |      |      |      |      |      |      |      |      |      |      | 2160 | 6420 | 6420 | 6420 | 6420 | 4260 |      |      |      |      |      |      |      |      |      |      |      |      |      |      |      |      |      |      |      |      |     |

 |      |      |      |      |      |      |      |      |      |      |      |      |      |   50 | 4730 | 4730 | 4730 | 4730 | 4680 |      |      |      |      |      |      |      |      |      |      |      |      |      |      |      |      |      |      |      |      |     |

 |      |      |      |      |      |      |      |      |      |      |      |      |      |      | 2940 | 2940 | 2940 | 2940 | 2940 |      |      |      |      |      |      |      |      |      |      |      |      |      |      |      |      |      |      |      |      |     |

 |      |      |      |      |      |      |      |      |      |      |      |      |      |      | 1840 | 1840 | 1840 | 1840 | 1840 |      |      |      |      |      |      |      |      |      |      |      |      |      |      |      |      |      |      |      |      |     |

 |      |      |      |      |      |      |      |      |      |      |      |      |      |      | 1040 | 1040 | 1040 | 1040 | 1040 |      |      |      |      |      |      |      |      |      |      |      |      |      |      |      |      |      |      |      |      |     |

 |      |      |      |      |      |      |      |      |      |      |      |      |      |      |  420 |  420 |  420 |  420 |  420 |      |      |      |      |      |      |      |      |      |      |      |      |      |      |      |      |      |      |      |      |     |

 |      |      |      |      |      |      |      |      |      |      |      |      |      |      |      |      |      |      |      |      |      |      |      |      |      |      |      |      |      |      |      |      |      |      |      |      |      |      |      |     |

 |      |      |      |      |      |      |      |      |      |      |      |      |      |      |      |      |      |      |      |      |      |      |      |      |      |      |      |      |      |      |      |      |      |      |      |      |      |      |      |     |

 |      |      |      |      |      |      |      |      |      |      |      |      |      |      |      |      |      |      |      |      |      |      |      |      |      |      |      |      |      |      |      |      |      |      |      |      |      |      |      |     |

 |      |      |      |      |      |      |      |      |      |      |      |      |      |      |      |      |      |      |      |      |      |      |      |      |      |      |      |      |      |      |      |      |      |      |      |      |      |      |      |     |

 |      |      |      |      |      |      |      |      |      |      |      |      |      |      |      |      |      |      |      |      |      |      |      |      |      |      |      |      |      |      |      |      |      |      |      |      |      |      |      |     |

 |      |      |      |      |      |      |      |      |      |      |      |      |      |      |      |      |      |      |      |      |      |      |      |      |      |      |      |      |      |      |      |      |      |      |      |      |      |      |      |     |

 |      |      |      |      |      |      |      |      |      |      |      |      |      |      |      |      |      |      |      |      |      |      |      |      |      |      |      |      |      |      |      |      |      |      |      |      |      |      |      |     |

 |      |      |      |      |      |      |      |      |      |      |      |      |      |      |      |      |      |      |      |      |      |      |      |      |      |      |      |      |      |      |      |      |      |      |      |      |      |      |      |     |

