 |      |      |      |      |      |      |      |      |      |      |      |      |      |      |      |      |      |      |      |      |      |      |      |      |      |      |      |      |      |      |      |      |      |      |      |      |  870 |  870 |  870 |  870|

 |      |      |      |      |      |      |      |      |      |      |      |      |      |      |      |      |      |      |      |      |      |      |      |      |      |      |      |      |      |      |      |      |      |      |      |   60 | 1230 | 1230 | 1230 | 1230|

 |      |      |      |      |      |      |      |      |      |      |      |      |      |      |      |      |      |      |      |      |      |      |      |      |      |      |      |      |      |      |      |      |      |      |      |  450 | 1620 | 1620 | 1620 | 1620|

 |      |      |      |      |      |      |      |      |      |      |      |      |      |      |      |      |      |      |      |      |      |      |      |      |      |      |      |      |      |      |      |      |      |      |  420 |  960 | 1980 | 1980 | 1980 | 1560|

 |      |      |      |      |      |      |      |      |      |      |      |      |      |      |      |      |      |      |      |      |      |      |      |      |      |      |      |      |      |      |      |      |      |  120 |  810 | 1350 | 1950 | 1950 | 1830 | 1140|

 |      |      |      |      |      |      |      |      |      |      |      |      |      |      |      |      |      |      |      |      |      |      |      |  600 |  600 |  600 |  600 |  600 |      |      |      |      |      |  870 | 1560 | 2100 | 2400 | 2400 | 1530 |  840|

 |      |      |      |      |      |      |      |      |      |      |      |      |      |      |      |      |      |      |      |      |      |      |      |  900 |  900 |  900 |  900 |  900 |      |      |      |      | 1470 | 2400 | 3090 | 3570 | 3570 | 2100 | 1170 |  480|

 |      |      |      |      |      |      |      |      |      |      |      |      |      |      |      |      |      |      |      |      |      |      |      | 1200 | 1200 | 1200 | 1200 | 1200 |      |      |      | 1020 | 2490 | 3420 | 4110 | 4200 | 3180 | 1710 |  780 |   90|

 |      |      |      |      |      |      |      |      |      |      |      |      |      |      |      |      |      |      |      |      |      |      |      | 1500 | 1500 | 1500 | 1500 | 1500 |      |      |      | 1410 | 2880 | 3810 | 4080 | 4080 | 2670 | 1200 |  270 |     |

 |      |      |      |      |      |      |      |      |      |      |      |      |      |      |      |      |      |      |      |      |      |      |      | 1800 | 1800 | 1800 | 1800 | 1800 |      |      |      | 1710 | 3180 | 3990 | 3990 | 3990 | 2280 |  810 |      |     |

 |      |      |      |      |      |      |      |      |      |      |      |      |      |      |      |      |      |      |      |      |      |      |      | 1500 | 1500 | 1500 | 1500 | 1500 |      |      |      | 2010 | 3480 | 3540 | 3540 | 3540 | 1530 |   60 |      |     |

 |      |      |      |      |      |      |      |      |      |      |      |      |      |      |      |      |      |      |      |      |      |      |      | 1500 | 1500 | 1500 | 1500 | 1500 |      |      |      | 2310 | 2310 | 2310 | 2310 | 2310 |      |      |      |     |

 |      |      |      |      |      |      |      |      |      |      |      |      |      |      |      |      |      |      |      |      |      |      |      | 1500 | 1500 | 1500 | 1500 | 1500 |      |      |      | 1590 | 1590 | 1590 | 1590 | 1590 |      |      |      |     |

 |      |      |      |      |      |      |      |      |      |      |      |      |      |      |      |      |      |      |      |      |      |      |      | 1500 | 1500 | 1500 | 1500 | 1500 |      |      |      | 1500 | 1500 | 1500 | 1500 | 1500 |      |      |      |     |

 |      |      |      |      |      |      |      |      |      |      |      |      |      |      |      |      |      |      |      |      |      |      |      | 1500 | 1500 | 1500 | 1500 | 1500 |      |      |      | 1500 | 1500 | 1500 | 1500 | 1500 |      |      |      |     |

 |      |      |      |      |      |      |      |      |      |      |      |      |      |      |      |      |      |      |      |      |      |      |      | 2550 | 2970 | 2970 | 2970 | 2970 |  420 |      |      | 1500 | 1500 | 1500 | 1500 | 1500 |      |      |      |     |

 |      |      |      |      |      |      |      |      |      |      |      |      |      |      |      |      |      |      |      |      |      |      |      | 2520 | 2940 | 2940 | 2940 | 2940 |  420 |      |      | 1500 | 1500 | 1500 | 1500 | 1500 |      |      |      |     |

 |      |      |      |      |      |      |      |      |      |      |      |      |      |      |      |      |      |      |      |      |      |      |      | 2520 | 2940 | 2940 | 2940 | 2940 |  420 |      |      | 1500 | 1500 | 1500 | 1500 | 1500 |      |      |      |     |

 |      |      |      |      |      |      |      |      |      |      |      |      |      |      |      |      |      |      |      |      |      |      |      | 3600 | 4020 | 4020 | 4020 | 4020 |  420 |      |  120 | 1560 | 1560 | 1560 | 1560 | 1440 |      |      |      |     |

 |      |      |      |      |      |      |      |      |      |      |      |      |      |      |      |      |      |      |      |      |      |      |      | 4620 | 5070 | 5070 | 5070 | 5070 |  450 |      |  480 | 1620 | 1620 | 1620 | 1620 | 1140 |      |      |      |     |

 |      |      |      |      |      |      |      |      |      |      |      |      |      |      |      |      |      |      |      |      |      |      |      | 4470 | 4650 | 4650 | 4650 | 4650 |  180 |  420 |  900 | 1740 | 1740 | 1740 | 1320 |  840 |      |      |      |     |

 |      |      |      |      |      |      |      |      |      |      |      |      |      |      |      |      |      |      |      |      |      |      |      | 6240 | 6420 | 6420 | 6420 | 6540 |  720 |  990 | 1470 | 2010 | 1890 | 1470 | 1020 |  540 |      |      |      |     |

 |      |      |      |      |      |      |      |      |      |      |      |      |      |      |      |      |      |      |      |      |      |      |      | 12390 | 13920 | 14700 | 15300 | 15780 | 3810 | 2730 | 2430 | 2070 | 1590 | 1170 |  720 |  240 |      |      |      |     |

 |      |      |      |      |      |      |      |      |      |      |      |      |      |      |      |      |      |      |      |      |      |      |      | 11010 | 12540 | 13320 | 13920 | 14400 | 3810 | 2730 | 2310 | 1710 | 1230 |  810 |  360 |      |      |      |      |     |

 |      |      |      |      |      |      |      |      |      |      |      |      |      |      |      |      |      |      |      |      |      |      |      | 9690 | 11190 | 11970 | 12570 | 13050 | 3780 | 2730 | 1950 | 1350 |  870 |  450 |      |      |      |      |      |     |

 |      |      |      |      |      |      |      |      |      |      |      |      |      |      |      |      |      |      |      |      |      |      |      | 8490 | 9840 | 10620 | 11220 | 11700 | 3630 | 2310 | 1530 |  930 |  450 |   30 |      |      |      |      |      |     |

 |      |      |      |      |      |      |      |      |      |      |      |      |      |      |      |      |      |      |      |      |      |      |      | 6450 | 7800 | 8580 | 9180 | 9540 | 3090 | 1740 |  960 |  360 |      |      |      |      |      |      |      |     |

 |      |      |      |      |      |      |      |      |      |      |      |      |      |      |      |      |      |      |      |      |      |      |      |      |      |      |      |      |      |      |      |      |      |      |      |      |      |      |      |     |

 |      |      |      |      |      |      |      |      |      |      |      |      |      |      |      |      |      |      |      |      |      |      |      |      |      |      |      |      |      |      |      |      |      |      |      |      |      |      |      |     |

 |      |      |      |      |      |      |      |      |      |      |      |      |      |      |      |      |      |      |      |      |      |      |      |      |      |      |      |      |      |      |      |      |      |      |      |      |      |      |      |     |

 |      |      |      |      |      |      |      |      |      |      |      |      |      |      |      |      |      |      |      |      |      |      |      |      |      |      |      |      |      |      |      |      |      |      |      |      |      |      |      |     |

 |      |      |      |      |      |      |      |      |      |      |      |      |      |      |      |      |      |      |      |      |      |      |      |      |      |      |      |      |      |      |      |      |      |      |      |      |      |      |      |     |

 |      |      |      |      |      |      |      |      |      |      |      |      |      |      |      |      |      |      |      |      |      |      |      |      |      |      |      |      |      |      |      |      |      |      |      |      |      |      |      |     |

 |      |      |      |      |      |      |      |      |      |      |      |      |      |      |      |      |      |      |      |      |      |      |      |      |      |      |      |      |      |      |      |      |      |      |      |      |      |      |      |     |

 |      |      |      |      |      |      |      |      |      |      |      |      |      |      |      |      |      |      |      |      |      |      |      |      |      |      |      |      |      |      |      |      |      |      |      |      |      |      |      |     |

 |      |      |      |      |      |      |      |      |      |      |      |      |      |      |      |      |      |      |      |      |      |      |      |      |      |      |      |      |      |      |      |      |      |      |      |      |      |      |      |     |

 |      |      |      |      |      |      |      |      |      |      |      |      |      |      |      |      |      |      |      |      |      |      |      |      |      |      |      |      |      |      |      |      |      |      |      |      |      |      |      |     |

 |      |      |      |      |      |      |      |      |      |      |      |      |      |      |      |      |      |      |      |      |      |      |      |      |      |      |      |      |      |      |      |      |      |      |      |      |      |      |      |     |

 |      |      |      |      |      |      |      |      |      |      |      |      |      |      |      |      |      |      |      |      |      |      |      |      |      |      |      |      |      |      |      |      |      |      |      |      |      |      |      |     |

 |      |      |      |      |      |      |      |      |      |      |      |      |      |      |      |      |      |      |      |      |      |      |      |      |      |      |      |      |      |      |      |      |      |      |      |      |      |      |      |     |

