 |      |      |      |      |      |      |      |   90 |  390 |  690 |  990 | 1290 | 1500 | 1500 | 1500 | 1500 | 1500 | 1500 | 1500 | 1680 | 2400 | 2460 | 2160 | 1860 | 1380 |  360 |      |      |      |      |      |      |      |      |      |      |  840 |  840 |  840 |  840|

 |      |      |      |  360 |  750 | 1110 | 1410 | 1740 | 1680 | 1590 | 1530 | 1530 | 1500 | 1500 | 1500 | 1500 | 1500 | 1500 | 1500 | 1680 | 2400 | 3030 | 2970 | 2670 | 2190 | 1170 |  240 |      |      |      |      |      |      |      |      |      | 1140 | 1140 | 1140 | 1140|

 |      |   30 |  660 | 1140 | 1530 | 1890 | 2160 | 1860 | 1680 | 1590 | 1530 | 1530 | 1500 | 1500 | 1500 | 1500 | 1500 | 1500 | 1500 | 1680 | 2400 | 3030 | 3600 | 3300 | 2820 | 1800 |  870 |      |      |      |      |      |      |      |      |      | 1470 | 1470 | 1470 | 1470|

 |      |  690 | 1320 | 1800 | 2190 | 2550 | 2160 | 1860 | 1680 | 1590 | 1530 | 1530 | 1500 | 1500 | 1500 | 1500 | 1500 | 1500 | 1500 | 1680 | 2400 | 3030 | 3720 | 3780 | 3300 | 2280 | 1350 |  360 |      |      |      |      |      |      |      |  240 | 1620 | 1620 | 1620 | 1620|

 |  330 | 1170 | 1800 | 2280 | 2670 | 2700 | 2160 | 1860 | 1680 | 1590 | 1530 | 1530 | 1500 | 1500 | 1500 | 1500 | 1380 | 1080 |  780 |  480 | 1020 | 1770 | 2760 | 3510 | 3510 | 2670 | 1740 |  750 |      |      |      |      |      |      |      |  570 | 1560 | 1560 | 1560 | 1560|

 |  810 | 1650 | 2280 | 2760 | 3150 | 2700 | 2160 | 1770 | 1290 |  900 |  540 |  240 |      |      |      |      |      |      |      |      |      |  570 | 1560 | 3480 | 3480 | 3480 | 2910 | 1920 |      |      |      |      |      |      |      |  870 | 1560 | 1560 | 1560 | 1560|

 | 1260 | 2100 | 2730 | 2850 | 2790 | 1590 |  750 |  120 |      |      |      |      |      |      |      |      |      |      |      |      |      |      |  750 | 2970 | 2970 | 2970 | 2970 | 2220 |      |      |      |      |      |      |      | 1170 | 1560 | 1560 | 1560 | 1560|

 | 12090 | 12900 | 12900 | 12900 | 2010 |  810 |      |      |      |      |      |      |      |      |      |      |      |      |      |      |      |      |  120 | 2640 | 2640 | 2640 | 2640 | 2520 |      |      |      |      |      |      |  120 | 1500 | 1560 | 1560 | 1560 | 1440|

 | 12090 | 12240 | 12240 | 12240 | 1350 |  150 |      |      |      |      |      |      |      |      |      |      |      |      |      |      |      |      |      | 2460 | 2460 | 2460 | 2460 | 2460 |      |      |      |      |      |      |  570 | 1710 | 1710 | 1710 | 1710 | 1140|

 | 11760 | 11760 | 11760 | 11760 |  870 |      |      |      |      |      |      |      |      |      |      |      |      |      |      |      |      |      |      | 3330 | 3330 | 3330 | 3330 | 3330 |      |      |      |      |      |  750 | 1440 | 2250 | 2250 | 2250 | 1500 |  810|

 | 11280 | 11280 | 11280 | 11280 |  390 |      |      |      |      |      |      |      |      |      |      |      |      |      |      |      |      |      |      | 2430 | 2430 | 2430 | 2430 | 2430 |      |      |      |  810 | 2280 | 3210 | 3900 | 4410 | 3600 | 2130 | 1200 |  510|

 | 10830 | 10830 | 10830 | 10830 |      |      |      |      |      |      |      |      |      |      |      |      |      |      |      |      |      |      |      | 2430 | 2430 | 2430 | 2430 | 2430 |      |      |      | 1560 | 3030 | 3960 | 4650 | 4860 | 3300 | 1830 |  900 |  210|

 |      |      |      |      |      |      |      |      |      |      |      |      |      |      |      |      |      |      |      |      |      |      |      | 2430 | 2430 | 2430 | 2430 | 2430 |      |      |      | 1950 | 3420 | 4350 | 4920 | 4920 | 2970 | 1500 |  570 |     |

 |      |      |      |      |      |      |      |      |      |      |      |      |      |      |      |      |      |      |      |      |      |      |      | 2910 | 2910 | 2910 | 2910 | 2910 |      |      |      | 2280 | 3750 | 4680 | 4800 | 4800 | 2520 | 1050 |  120 |     |

 |      |      |      |      |      |      |      |      |      |      |      |      |      |      |      |      |      |      |      |      |      |      |      | 2460 | 2460 | 2460 | 2460 | 2460 |      |      |      | 2580 | 4050 | 4230 | 4230 | 4230 | 1650 |  180 |      |     |

 |      |      |      |      |      |      |      |      |      |      |      |      |      |      |      |      |      |      |      |      |      |      |      | 2490 | 2490 | 2490 | 2490 | 2490 |      |      |      | 2040 | 2040 | 2040 | 2040 | 2040 |      |      |      |     |

 |      |      |      |      |      |      |      |      |      |      |      |      |      |      |      |      |      |      |      |      |      |      |      | 2520 | 2520 | 2520 | 2520 | 2520 |      |      |      | 1590 | 1590 | 1590 | 1590 | 1590 |      |      |      |     |

 |      |      |      |      |      |      |      |      |      |      |      |      |      |      |      |      |      |      |      |      |      |      |      | 3570 | 3570 | 3570 | 3570 | 3570 |      |      |      | 1530 | 1530 | 1530 | 1530 | 1530 |      |      |      |     |

 |      |      |      |      |      |      |      |      |      |      |      |      |      |      |      |      |      |      |      |      |      |      |  270 | 3090 | 3090 | 3090 | 3090 | 2820 |      |      |  180 | 1560 | 1560 | 1560 | 1560 | 1380 |      |      |      |     |

 |      |      |      |      |      |      |      |      |      |      |      |      |      |      |      |      |      |      |      |      |      |      |  270 | 2670 | 2670 | 2670 | 2670 | 2400 |      |  210 |  660 | 1740 | 1740 | 1740 | 1530 | 1080 |      |      |      |     |

 |      |      |      |      |      |      |      |      |      |      |      |      |      |      |      |      |      |      |      |      |      |      |  270 | 4020 | 4680 | 4680 | 4680 | 4710 | 1380 | 1080 | 1530 | 2340 | 2040 | 1620 | 1260 |  810 |      |      |      |     |

 |      |      |      |      |      |      |      |      |      |      |      |      |      |      |      |      |      |      |      |      |      |      |  270 | 3690 | 4830 | 5580 | 6180 | 6390 | 3390 | 2610 | 2310 | 2220 | 1740 | 1320 |  960 |  510 |      |      |      |     |

 |      |      |      |      |      |      |      |      |      |      |      |      |      |      |      |      |      |      |      |      |      |      |  270 | 2340 | 3480 | 4230 | 4830 | 5040 | 3390 | 2610 | 2310 | 1890 | 1410 |  990 |  630 |  180 |      |      |      |     |

 |      |      |      |      |      |      |      |      |      |      |      |      |      |      |      |      |      |      |      |      |      |      |      | 2040 | 3180 | 3930 | 4530 | 5010 | 3390 | 2610 | 2130 | 1530 | 1050 |  630 |  270 |      |      |      |      |     |

 |      |      |      |      |      |      |      |      |      |      |      |      |      |      |      |      |      |      |      |      |      |      |      | 1650 | 2790 | 3540 | 4140 | 4620 | 3390 | 2400 | 1650 | 1050 |  570 |  150 |      |      |      |      |      |     |

 |      |      |      |      |      |      |      |      |      |      |      |      |      |      |      |      |      |      |      |      |      |      |      |      |  480 | 1230 | 1830 | 2010 | 2010 | 1530 |  780 |  180 |      |      |      |      |      |      |      |     |

 |      |      |      |      |      |      |      |      |      |      |      |      |      |      |      |      |      |      |      |      |      |      |      |      |      |      |      |      |      |      |      |      |      |      |      |      |      |      |      |     |

 |      |      |      |      |      |      |      |      |      |      |      |      |      |      |      |      |      |      |      |      |      |      |      |      |      |      |      |      |      |      |      |      |      |      |      |      |      |      |      |     |

 |      |      |      |      |      |      |      |      |      |      |      |      |      |      |      |      |      |      |      |      |      |      |      |      |      |      |      |      |      |      |      |      |      |      |      |      |      |      |      |     |

 |      |      |      |      |      |      |      |      |      |      |      |      |      |      |      |      |      |      |      |      |      |      |      |      |      |      |      |      |      |      |      |      |      |      |      |      |      |      |      |     |

 |      |      |      |      |      |      |      |      |      |      |      |      |      |      |      |      |      |      |      |      |      |      |      |      |      |      |      |      |      |      |      |      |      |      |      |      |      |      |      |     |

 |      |      |      |      |      |      |      |      |      |      |      |      |      |      |      |      |      |      |      |      |      |      |      |      |      |      |      |      |      |      |      |      |      |      |      |      |      |      |      |     |

 |      |      |      |      |      |      |      |      |      |      |      |      |      |      |      |      |      |      |      |      |      |      |      |      |      |      |      |      |      |      |      |      |      |      |      |      |      |      |      |     |

 |      |      |      |      |      |      |      |      |      |      |      |      |      |      |      |      |      |      |      |      |      |      |      |      |      |      |      |      |      |      |      |      |      |      |      |      |      |      |      |     |

 |      |      |      |      |      |      |      |      |      |      |      |      |      |      |      |      |      |      |      |      |      |      |      |      |      |      |      |      |      |      |      |      |      |      |      |      |      |      |      |     |

 |      |      |      |      |      |      |      |      |      |      |      |      |      |      |      |      |      |      |      |      |      |      |      |      |      |      |      |      |      |      |      |      |      |      |      |      |      |      |      |     |

 |      |      |      |      |      |      |      |      |      |      |      |      |      |      |      |      |      |      |      |      |      |      |      |      |      |      |      |      |      |      |      |      |      |      |      |      |      |      |      |     |

 |      |      |      |      |      |      |      |      |      |      |      |      |      |      |      |      |      |      |      |      |      |      |      |      |      |      |      |      |      |      |      |      |      |      |      |      |      |      |      |     |

 |      |      |      |      |      |      |      |      |      |      |      |      |      |      |      |      |      |      |      |      |      |      |      |      |      |      |      |      |      |      |      |      |      |      |      |      |      |      |      |     |

 |      |      |      |      |      |      |      |      |      |      |      |      |      |      |      |      |      |      |      |      |      |      |      |      |      |      |      |      |      |      |      |      |      |      |      |      |      |      |      |     |

